ref_sci,fws_exp,other_fed_exp,state_exp,total_exp,years_rep,max_exp,median_exp
Abronia macrocarpa,137700,6050,157898,301648,15,91580,9900
Abutilon eremitopetalum,97591,5412,8937,111940,15,18085,8700
Abutilon menziesii,341034,389445,659525,1390004,15,257122,86182
Abutilon sandwicense,106063,1358117,8046,1472226,14,441396,72653
Acaena exigua,135521,1987,4482,141990,15,41210,4400
Acanthomintha ilicifolia,2702116,47654,8300,2758070,15,1954815,12400
Acanthomintha obovata ssp. duttonii,50268,3717,0,53985,8,43998,1311.5
Accipiter gentilis laingi,21652,0,0,21652,1,21652,21652
Accipiter striatus venator,391500,344035,0,735535,15,126500,26500
Achatinella spp.,2681016,6940469,30900,9652385,15,1261375,626181
Achyranthes mutica,123396,1677,21631,146704,15,25224,5500
Achyranthes splendens var. rotundata,202902,94495,7822,305219,14,98368,14366.5
Acinonyx jubatus,0,212250,0,212250,1,212250,212250
Acipenser brevirostrum,6113641,33771266,819662,40704569,15,13469793,1965541
Acipenser medirostris,452706,43346976,223435,44023117,9,19971774,3605068
Acipenser oxyrinchus (=oxyrhynchus) desotoi,742075,5276248,32543,6050866,2,3554954,3025433
Acipenser oxyrinchus oxyrinchus,729539,14449045,519659,15698243,4,3626332,963641.5
Acipenser transmontanus,5892098,121270121,1994495,129156714,15,13632338,8925631
Acmispon dendroideus var. traskiae (=Lotus d. ssp. traskiae),60174,996845,0,1057019,3,374730,351827
Aconitum noveboracense,744008,46036,34200,824244,15,291600,40025
Acrocephalus familiaris kingi,681319,52465,0,733784,12,304677,42481.5
Acrocephalus luscinia,1702240,112700,176100,1991040,15,287963,152530
Acrocephalus percernis aquilonis,794,0,0,794,1,794,794
Acropora cervicornis,10000,9154333,0,9164333,9,2560317,1013144
Acropora globiceps,0,1005824,0,1005824,1,1005824,1005824
Acropora jacquelinae,0,349861,0,349861,1,349861,349861
Acropora lokani,0,349861,0,349861,1,349861,349861
Acropora palmata,10000,9696953,0,9706953,9,2460760,1173382
Acropora pharaonis,0,349861,0,349861,1,349861,349861
Acropora retusa,0,127843,0,127843,1,127843,127843
Acropora rudis,0,349861,0,349861,1,349861,349861
Acropora speciosa,0,349861,0,349861,1,349861,349861
Addax nasomaculatus,0,300,0,300,1,300,300
Adelocosa anops,371213,12000,0,383213,14,80905,18881.5
Adenophorus periens,190868,51335,6869,249072,14,66883,11189.5
Adiantum vivesii,57000,100,0,57100,14,15000,3500
Aerodramus vanikorensis bartschi,444531,7510600,106100,8061231,15,2467370,279225
Aeschynomene virginica,275575,103099,17579,396253,15,56827,21685
Agalinis acuta,188869,210382,102877,502128,14,164639,23241.5
Agave arizonica,77511,1600,1250,80361,6,42811,7700
Agave eggersiana,11100,100,0,11200,1,11200,11200
Agelaius xanthomus,2044300,319910,692837,3057047,14,338573,218074.5
Ailuropoda melanoleuca,0,469000,0,469000,1,469000,469000
Akialoa stejnegeri,82076,0,0,82076,1,82076,82076
Alasmidonta atropurpurea,744200,171953,54700,970853,15,166761,51610
Alasmidonta heterodon,1322204,4062394,819372,6203970,15,1037981,334218
Alasmidonta raveneliana,2403400,685076,476519,3564995,15,637938,187177
Alectryon macrococcus,306456,1611304,20011,1937771,15,228645,125824
Alligator mississippiensis,2647282,4325276,6329920,13302478,14,1800948,978891.5
Allium munzii,467138,57812,6200,531150,15,115500,13600
Alopecurus aequalis var. sonomensis,280873,255115,530,536518,15,110870,27762
Amaranthus brownii,129369,1677,3643,134689,15,91295,3100
Amaranthus pumilus,958236,4231677,48597,5238510,15,1035827,295080
Amazona vittata,19122500,2688165,2163480,23974145,15,1915235,1556868
Amblema neislerii,1481275,1003058,12000,2496333,15,331383,140515
Amblyopsis rosae,1379318,275197,588750,2243265,15,314100,141600
Ambrosia cheiranthifolia,443002,389817,30816,863635,15,254100,47452
Ambrosia pumila,2829242,206215,15000,3050457,14,1834875,40865.5
Ambrysus amargosus,197991,46526,0,244517,14,50272,13713
Ambystoma bishopi,266539,1772619,81418,2120576,7,490973,313250
Ambystoma californiense,17117918,23769707,49000,40936625,15,5135895,821170
Ambystoma cingulatum,2466145,5478980,365123,8310248,15,1871520,391395
Ambystoma macrodactylum croceum,3535271,17373,43500,3596144,14,1828507,96540
Ambystoma tigrinum stebbinsi,234470,1126005,207688,1568163,15,305900,69100
Ameiva polops,247600,208375,0,455975,15,73000,22000
Ammodramus maritimus mirabilis,2707406,15370545,0,18077951,15,5772100,731274
Ammodramus savannarum floridanus,2353175,4201274,261531,6815980,15,861914,482473
Amorpha crenulata,72200,112106,72400,256706,15,33050,23300
Amphianthus pusillus,60600,70879,51020,182499,15,22083,11000
Amphispiza belli clementeae,25329,4753753,1000,4780082,15,1229167,156888
Amsinckia grandiflora,1077832,86521,0,1164353,13,883727,24650
Amsonia kearneyana,21424,57579,10700,89703,15,16000,4095
Anaea troglodyta floridalis,164259,29250,0,193509,2,129609,96754.5
Anas laysanensis,1066651,1718451,0,2785102,15,495641,165390
Anas oustaleti,17854,0,0,17854,4,11553,2300.5
Anas wyvilliana,3699443,4525776,42528,8267747,15,2352043,403642
Anaxyrus californicus,1218049,3868949,0,5086998,4,1842962,1104780
Anaxyrus canorus,621306,144642,0,765948,2,533642,382974
Anguispira picta,137500,2300,0,139800,13,29500,7700
Anolis roosevelti,108100,1190,0,109290,12,43000,7000
Antilocapra americana sonoriensis,3081378,16000145,3059245,22140768,15,5827743,978225
Antrobia culveri,503988,174935,62600,741523,14,121200,44300
Antrolana lira,516263,160092,23246,699601,15,135105,43000
Aphelocoma coerulescens,11265616,21535167,695395,33496178,15,5011138,2146215
Apios priceana,424700,983070,12160,1419930,15,245510,81570
Aplodontia rufa nigra,910281,400190,19000,1329471,15,242193,72000
Apodemia mormo langei,950078,382180,6000,1338258,15,273249,90705
Aproteles bulmerae,0,150,0,150,1,150,150
Arabis georgiana,100,2734,0,2834,1,2834,2834
Arabis hoffmannii,29396,113951,200,143547,12,36700,7104
Arabis macdonaldiana,211090,119242,0,330332,8,108306,33125
Arabis perstellata,366950,50937,30700,448587,15,96450,24200
Arabis serotina,184521,136791,34350,355662,15,86549,17531
Arctocephalus townsendi,0,1514410,1200,1515610,12,571291,46678
Arctomecon humilis,258100,2272565,4700,2535365,15,1551000,50950
Arctostaphylos confertiflora,240880,136792,0,377672,15,186469,8066
Arctostaphylos franciscana,385258,11000,0,396258,3,339628,28950
Arctostaphylos glandulosa ssp. crassifolia,92681,470380,1800,564861,12,163673,34345.5
Arctostaphylos hookeri var. ravenii,163071,34810,0,197881,12,140293,3618
Arctostaphylos morroensis,197438,29735,5000,232173,15,77555,7645
Arctostaphylos myrtifolia,364631,315754,34400,714785,15,145608,36000
Arctostaphylos pallida,241629,300,3500,245429,12,45378,20000
Arenaria cumberlandensis,297900,75929,4330,378159,15,56225,19790
Arenaria paludicola,585901,213610,3700,803211,15,136107,51470
Arenaria ursina,303471,550082,0,853553,15,265935,30841
Argemone pleiacantha ssp. pinnatisecta,237963,424795,0,662758,13,132800,26000
Argyroxiphium kauense,525598,547328,54645,1127571,15,360152,55106
Argyroxiphium sandwicense ssp. macrocephalum,131961,376535,4707,513203,14,116438,25715.5
Argyroxiphium sandwicense ssp. sandwicense,193104,954,51507,245565,15,34243,16224
Aristida chaseae,89000,400,0,89400,14,12000,6250
Aristida portoricensis,76400,400,0,76800,15,11000,4000
Arkansia wheeleri,540638,2453189,64078,3057905,15,2170960,61261
Asclepias meadii,639709,309647,181746,1131102,15,150846,67654
Asclepias welshii,29464,365845,18000,413309,15,68000,22300
Asimina tetramera,64000,180466,29100,273566,15,82110,10700
Asplenium dielerectum,11208,1000,0,12208,1,12208,12208
Asplenium dielfalcatum,6730,0,0,6730,1,6730,6730
Asplenium dielmannii,16027,0,0,16027,1,16027,16027
Asplenium dielpallidum,23088,0,0,23088,1,23088,23088
Asplenium peruvianum var. insulare,9790,147800,0,157590,1,157590,157590
Asplenium scolopendrium var. americanum,194337,58297,10700,263334,15,60471,8597
Asplenium unisorum,4866,3793,0,8659,1,8659,8659
Assiminea pecos,153170,148670,14750,316590,11,74127,13650
Astelia waialealae,116478,1577,6410,124465,6,25686,21677.5
Astragalus albens,109204,245312,0,354516,13,101000,20000
Astragalus ampullarioides,279630,583375,0,863005,15,204700,42000
Astragalus applegatei,545928,212294,600,758822,15,150751,55350
Astragalus bibullatus,373100,42855,935,416890,15,50600,26616
Astragalus brauntonii,274957,195632,4100,474689,14,116778,18056
Astragalus clarianus,28886,300,200,29386,6,16288,2131
Astragalus cremnophylax var. cremnophylax,233818,593113,12200,839131,15,159000,41900
Astragalus desereticus,72000,32864,400,105264,14,42500,3250
Astragalus holmgreniorum,380845,2138421,12700,2531966,15,1557075,69200
Astragalus humillimus,68736,93796,0,162532,15,39938,9593
Astragalus jaegerianus,833917,3476602,200,4310719,15,729563,243000
Astragalus lentiginosus var. coachellae,1002364,404835,2000,1409199,13,338413,70182
Astragalus lentiginosus var. piscinensis,258143,163800,0,421943,15,89235,16393
Astragalus magdalenae var. peirsonii,749796,4812700,10400,5572896,15,1302200,265664
Astragalus montii,35100,82335,400,117835,14,75800,3050
Astragalus osterhoutii,31070,196405,0,227475,15,34425,17700
Astragalus phoenix,277426,54213,0,331639,11,85396,26003
Astragalus pycnostachyus var. lanosissimus,325152,7887,79200,412239,15,129200,19100
Astragalus robbinsii var. jesupi,187081,6213,32018,225312,15,40145,13600
Astragalus tener var. titi,39919,9000,0,48919,10,21600,2950
Astragalus tricarinatus,879317,150247,2200,1031764,15,384450,13500
Astrophytum asterias,926600,269114,401292,1597006,15,537156,53416
Atelopus varius zeteki,52020,83520,0,135540,1,135540,135540
Athearnia anthonyi,200400,29185,7656,237241,15,37920,5664
Atriplex coronata var. notatior,315435,2823,500,318758,12,110000,5110
Auerodendron pauciflorum,55900,100,0,56000,14,10500,3500
Ayenia limitaris,605625,232470,23760,861855,15,273100,47965
Babyrousa babyrussa,1000,0,0,1000,1,1000,1000
Baccharis vanessae,49908,118004,1900,169812,12,88700,5297.5
Balaena mysticetus,7500,52488578,25000,52521078,15,25859765,1950827
Balaenoptera borealis,1072,16101931,48643,16151646,15,4147048,470079
Balaenoptera musculus,1200,18483974,48643,18533817,15,4198058,306429
Balaenoptera physalus,3472,17441964,318412,17763848,15,3814423,877306
Banara vanderbiltii,63500,200,0,63700,14,13500,3000
Baptisia arachnifera,644000,4975,77100,726075,14,521000,16000
Batrachoseps aridus,547736,10170,700,558606,13,375000,2500
Batrisodes texanus,209115,1334376,12014,1555505,15,1310000,4240
Batrisodes venyivi,334285,12480,10451,357216,14,202600,9720
Berberis (=Mahonia) sonnei,33025,0,0,33025,2,30225,16512.5
Berberis nevinii,420648,224627,1800,647075,14,243633,11006
Berberis pinnata ssp. insularis,59456,58703,0,118159,13,26362,7307
Betula uber,77544,5505,0,83049,12,20000,7000
Bidens amplectens,20959,1042,2796,24797,3,9767,8029
Bidens campylotheca pentamera,26925,1742,2796,31463,3,12652,10160
Bidens campylotheca waihoiensis,28135,1742,2796,32673,3,12905,11087
Bidens conjuncta,23725,1042,2796,27563,3,11366,8660
Bidens hillebrandiana ssp. hillebrandiana,13033,124,0,13157,2,8308,6578.5
Bidens micrantha ctenophylla,151463,33147,0,184610,2,115376,92305
Bidens micrantha ssp. kalealaha,115084,218324,4904,338312,15,57820,23100
Bidens wiebkei,490540,1577,4707,496824,14,170364,4228
Bison bison athabascae,1104093,33500,593934,1731527,7,954600,133578
Blennosperma bakeri,543753,502920,16200,1062873,14,494726,38665
Boloria acrocnema,90322,289150,0,379472,15,72285,21974
Boltonia decurrens,572461,563143,97410,1233014,15,134228,74333
Bonamia grandiflora,133203,948252,37870,1119325,15,317100,33100
Bonamia menziesii,591807,433208,38715,1063730,15,257702,46516
Brachylagus idahoensis,4048438,1370307,1750700,7169445,14,897716,451565
Brachyramphus marmoratus,22353170,36822443,13582073,72757686,15,7322553,4820134
Branchinecta conservatio,1185949,490457,3300,1679706,14,244509,113428.5
Branchinecta longiantenna,2398832,167835,0,2566667,15,925093,45021
Branchinecta lynchi,9815158,21607856,63000,31486014,15,4627010,1676046
Branchinecta sandiegonensis,3662125,4452039,8000,8122164,15,2033910,415542
Branta (=Nesochen) sandvicensis,5302742,7398939,1006720,13708401,15,1616963,1101201
Branta canadensis leucopareia,8000,6000,500,14500,1,14500,14500
Brickellia mosieri,85205,504,5000,90709,1,90709,90709
Brighamia insignis,117938,21725,5795,145458,14,39990,4289.5
Brighamia rockii,426019,78487,6708,511214,14,180664,14365
Brodiaea filifolia,731983,2038209,39900,2810092,15,609107,125792
Brodiaea pallida,195218,2460,0,197678,12,43945,15600
Brychius hungerfordi,660300,12214,2500,675014,15,163100,27200
Bufo hemiophrys baxteri,862195,17200,14074,893469,1,893469,893469
Bufo houstonensis,2405346,1011777,792964,4210087,15,455091,266015
Buteo platypterus brunnescens,366900,254601,0,621501,15,100726,30500
Buteo solitarius,1677483,1293852,556,2971891,15,415806,168682
Buxus vahlii,116600,795,0,117395,14,20500,8097.5
Cacatua moluccensis,14966,0,0,14966,1,14966,14966
Calamagrostis hillebrandii,20470,847,2796,24113,3,11171,7537
Calidris canutus rufa,464582,410159,2110,876851,1,876851,876851
Callicarpa ampla,59400,83516,0,142916,15,58500,4416
Callirhoe scabriuscula,29050,20826,34896,84772,15,33080,2140
Callithrix aurita (=jacchus a.),0,1200,0,1200,1,1200,1200
Callophrys mossii bayensis,126538,9570,0,136108,11,24157,8500
Calochortus tiburonensis,105976,22103,0,128079,10,31500,9261.5
Calyptranthes thomasiana,62600,40533,0,103133,15,15615,6500
Calyptridium pulchellum,229053,13555,0,242608,13,88500,9400
Calyptronoma rivalis,158600,100,0,158700,13,39500,7100
Calystegia stebbinsii,477374,2101032,100,2578506,15,1845000,42000
Cambarus aculabrum,242677,5101,1300,249078,14,35300,18000
Cambarus zophonastes,212300,4377,8550,225227,14,47000,16700
Camissonia benitensis,274575,843000,0,1117575,14,164598,77782.5
Campanula robinsiae,73700,6517,53926,134143,10,61250,7650
Campeloma decampi,49700,9089,5000,63789,11,11000,6500
Campephilus principalis,5166750,1713505,327624,7207879,15,2090755,35371
Canavalia molokaiensis,500331,66153,7164,573648,14,176500,7548
Canavalia napaliensis,65919,1577,2796,70292,6,36871,6235
Canavalia pubescens,64448,1142,2796,68386,3,24116,23660
Canis lupus,61073007,41947521,17781285,120801813,15,6954633,1560262
Canis lupus baileyi,3854715,649080,666000,5169795,3,3079515,1035390
Canis rufus,17035948,5237279,346046,22619273,15,3590255,620462.5
Capra walie,0,29667,0,29667,1,29667,29667
Caprimulgus noctitherus,405000,4872,0,409872,15,69000,25900
Cardamine micranthera,57571,18198,8820,84589,13,16000,6600
Caretta caretta,15294618,99734040,5799774,120828432,15,11285625,5695531
Carex albida,86824,1800,300,88924,11,31206,4000
Carex lutea,345000,20652,4956,370608,14,131190,12640
Carex specuicola,46072,34397,10600,91069,15,13388,4966
Castilleja affinis ssp. neglecta,271549,9373,0,280922,11,105050,21764
Castilleja campestris ssp. succulenta,401315,359067,19500,779882,15,240100,24795
Castilleja cinerea,120581,687463,0,808044,14,272735,42820
Castilleja grisea,153491,1732285,0,1885776,13,379786,121656
Castilleja levisecta,5901698,669505,17300,6588503,15,1242708,379107
Castilleja mollis,69237,123318,0,192555,15,27774,9807
Catesbaea melanocarpa,355300,995,0,356295,14,111900,13500
Catostomus discobolus yarrowi,24100,400,7000,31500,2,18800,15750
Catostomus microps,775570,181053,46286,1002909,15,209446,53555
Catostomus santaanae,1390423,17651338,51700,19093461,15,7437464,350897
Catostomus warnerensis,1539302,1228814,63532,2831648,15,418388,198612
Caulanthus californicus,408133,298091,0,706224,15,177782,44650
Ceanothus ferrisae,315338,7223,0,322561,12,67785,23033.5
Ceanothus ophiochilus,43786,3000,0,46786,7,16744,4379
Ceanothus roderickii,273870,2447900,800,2722570,15,1850000,40500
Cenchrus agrimonioides,279205,1473278,18621,1771104,15,299245,115078
Centaurium namophilum,592018,36713,0,628731,12,212078,24779
Centrocercus minimus,331216,1812033,540616,2683865,1,2683865,2683865
Ceratotherium simum cottoni,207376,0,0,207376,1,207376,207376
Cercocarpus traskiae,23109,140,200,23449,7,12784,1160
Cercopithecus diana,0,450,0,450,1,450,450
Cereus eriophorus var. fragrans,133050,12030,48200,193280,15,40000,7200
Cervus eldi,0,50050,0,50050,1,50050,50050
Chamaecrista glandulosa var. mirabilis,57800,800,0,58600,14,12200,3000
Chamaesyce deltoidea ssp. deltoidea,248500,17773,9600,275873,15,77100,5500
Chamaesyce garberi,95990,22353,4900,123243,15,33800,5700
Chamaesyce hooveri,252658,29877,1500,284035,13,62105,13364
Charadrius alexandrinus nivosus,17593047,37115030,951125,55659202,15,4872780,3846578
Charadrius melodus,18210745,120423724,5948312,144582781,15,18108135,3642228
Charpentiera densiflora,65898,1577,2796,70271,6,38088,7345
Chasiempis ibidis,22688,335483,0,358171,1,358171,358171
Chasmistes brevirostris,11224856,46553371,119203,57897430,15,7913485,3755014
Chasmistes cujus,3558538,11561226,700,15120464,15,2802590,987062
Chasmistes liorus,1270978,11476099,4379919,17126996,15,6626202,651100
Chelonia mydas,8734918,77656427,2801884,89193229,15,7593653,3071375
Chinchilla brevicaudata boliviana,300,0,0,300,1,300,300
Chionanthus pygmaeus,102222,6217,22600,131039,14,26000,7400
Chlorogalum purpureum,360206,1871124,2000,2233330,15,329905,136707
Chorizanthe howellii,392109,10900,2600,405609,13,231080,9900
Chorizanthe orcuttiana,344883,773499,4500,1122882,15,237273,40483
Chorizanthe pungens var. hartwegiana,243867,0,0,243867,12,61972,12335
Chorizanthe pungens var. pungens,824357,715956,0,1540313,15,203400,81770
Chorizanthe robusta var. hartwegii,39300,0,0,39300,1,39300,39300
Chorizanthe robusta var. robusta,10638,0,0,10638,2,6025,5319
Chorizanthe valida,48229,153665,0,201894,15,56016,6280
Chromolaena frustrata,1300,7000,2400,10700,2,8300,5350
Chrosomus saylori,59500,11847,0,71347,5,20000,14650
Chrysocyon brachyurus,0,259000,0,259000,1,259000,259000
Chrysopsis floridana,258314,8912,141500,408726,14,75156,26800
Cicindela dorsalis dorsalis,1740089,514222,49550,2303861,14,842241,128569
Cicindela nevadica lincolniana,1275080,149455,270900,1695435,10,322585,149416.5
Cicindela ohlone,329645,8700,0,338345,12,104354,20265
Cicindela puritana,3852985,168682,54292,4075959,15,2229631,83624
Cicurina baronia,360569,46190,13026,419785,15,203100,10098
Cicurina madla,362281,1589715,13410,1965406,15,342545,109710
Cicurina venii,371498,415345,10151,796994,14,342345,8985.5
Cicurina vespera,355678,31380,12985,400043,15,204700,10085
Cirsium fontinale var. fontinale,227877,7238,0,235115,11,90011,10000
Cirsium fontinale var. obispoense,156895,154047,500,311442,15,82773,12000
Cirsium hydrophilum var. hydrophilum,490037,41400,95000,626437,15,117075,44000
Cirsium loncholepis,568554,185676,1600,755830,15,165459,35435
Cirsium pitcheri,741534,804126,20652,1566312,15,240489,78850
Cirsium vinaceum,284865,284725,0,569590,15,205000,17000
Cladonia perforata,313501,559896,40800,914197,15,164340,76450
Clarkia franciscana,141702,181908,0,323610,15,49835,19300
Clarkia imbricata,182965,151700,0,334665,8,159500,30516.5
Clarkia speciosa ssp. immaculata,66121,600,0,66721,12,29590,3830
Clarkia springvillensis,85834,65950,1400,153184,15,38000,4900
Clematis morefieldii,109800,6795,1817,118412,14,29024,6058.5
Clematis socialis,160750,22822,25000,208572,15,47416,10850
Clemmys muhlenbergii,7116249,13772828,2053845,22942922,15,2545988,638002.5
Clermontia drepanomorpha,192056,4447,10684,207187,15,36100,10685
Clermontia lindseyana,544917,135583,30712,711212,15,162713,32103
Clermontia oblongifolia ssp. brevipes,87133,754,7275,95162,14,17304,5305
Clermontia oblongifolia ssp. mauiensis,135637,24192,4782,164611,14,30742,11506
Clermontia peleana,317733,111497,24962,454192,15,125197,29102
Clermontia pyrularia,507041,75577,15192,597810,15,160599,25842
Clermontia samuelii,72481,84017,6439,162937,15,21400,10531
Clitoria fragrans,109422,369000,23416,501838,15,101122,32900
Coccyzus americanus,885988,5946896,21100,6853984,1,6853984,6853984
Colinus virginianus ridgwayi,1322580,82755,42560,1447895,15,297500,27000
Colubrina oppositifolia,285393,535513,65437,886343,15,105378,60447
Columba inornata wetmorei,481000,40398,131700,653098,15,244000,22200
Conradina brevifolia,128200,3600,38216,170016,15,32750,7000
Conradina etonia,103603,2000,90600,196203,15,63500,6500
Conradina glabra,57057,107281,33200,197538,13,49200,12500
Conradina verticillata,718300,122627,1962,842889,15,163364,33933
Consolea corallicola,84458,5400,900,90758,2,80358,45379
Cordia bellonis,87700,100,0,87800,15,14000,5500
Cordylanthus maritimus ssp. maritimus,661763,617164,1600,1280527,15,258084,68673
Cordylanthus mollis ssp. mollis,735357,124600,90500,950457,14,189400,56233
Cordylanthus palmatus,668574,1195758,11000,1875332,15,739666,67245
Cordylanthus tenuis ssp. capillaris,130211,4089,0,134300,10,48500,2592.5
Cornutia obovata,73100,100,0,73200,14,14000,3000
Corvus hawaiiensis,10537614,190281,683157,11411052,15,1537659,749735
Corvus kubaryi,7455964,7328533,86200,14870697,15,2389692,873803
Corvus leucognaphalus,54500,65290,0,119790,11,75000,5500
Corynorhinus (=Plecotus) townsendii ingens,1656899,1527438,105599,3289936,15,495677,157950
Corynorhinus (=Plecotus) townsendii virginianus,1078902,2433312,445173,3957387,15,682250,192811
Coryphantha minima,13525,0,5550,19075,11,8000,1000
Coryphantha ramillosa,9233,12200,5450,26883,14,5100,1550
Coryphantha robbinsiorum,103550,750,4300,108600,4,61500,22875
Coryphantha scheeri var. robustispina,667767,1316710,42550,2027027,15,417000,116200
Coryphantha sneedii var. leei,37200,98570,200,135970,15,23500,8720
Coryphantha sneedii var. sneedii,41300,778830,16446,836576,15,150900,37000
Cottus paulus (=pygmaeus),117400,25999,21112,164511,15,35473,8500
Cottus specus,54707,37500,0,92207,2,50200,46103.5
Cranichis ricartii,51500,200,0,51700,14,9000,1750
Crax alberti,0,9100,0,9100,1,9100,9100
Crenichthys baileyi baileyi,384612,313653,14800,713065,15,237981,44668
Crenichthys baileyi grandis,372978,83923,26600,483501,15,71084,27143
Crenichthys nevadae,1213380,188683,134700,1536763,15,232726,65486
Crescentia portoricensis,64100,519,0,64619,14,10124,3000
Crocodylus acutus,784117,5484844,176473,6445434,15,2236345,171736
Crocodylus cataphractus,0,4000,0,4000,1,4000,4000
Crocodylus niloticus,250,0,0,250,1,250,250
Crocodylus siamensis,250,0,0,250,1,250,250
Crotalaria avonensis,148700,3700,94100,246500,15,44000,13500
Crotalus willardi obscurus,221625,784780,28380,1034785,15,290550,34530
Cryptantha crassipes,9900,600,40474,50974,12,23640,1325
Cryptobranchus alleganiensis bishopi,336145,108579,156400,601124,4,240900,132903
Crystallaria cincotta,133460,52633,5050,191143,3,125660,45151
Ctenitis squamigera,318500,263702,2896,585098,15,166161,26185
Cucurbita okeechobeensis ssp. okeechobeensis,304020,35957,19300,359277,14,232781,10358
Cumberlandia monodonta,273231,260661,47250,581142,4,227158,129033
Cupressus abramsiana,273095,300,250,273645,11,110775,11250
Cupressus goveniana ssp. goveniana,150298,5400,0,155698,10,65087,7657.5
Cyanea acuminata,252968,993114,5498,1251580,15,177630,74270
Cyanea asarifolia,111069,1577,6706,119352,15,37012,5000
Cyanea asplenifolia,26554,7042,2796,36392,3,14887,11167
Cyanea calycina,35534,1042,2796,39372,3,24137,8068
Cyanea copelandii ssp. copelandii,46686,954,5575,53215,15,10566,1700
Cyanea copelandii ssp. haleakalaensis,91457,64466,4030,159953,15,33989,8587
Cyanea crispa,14796,160333,0,175129,1,175129,175129
Cyanea dolichopoda,48441,1577,2796,52814,6,17105,7743.5
Cyanea dunbariae,13998,0,2131,16129,1,16129,16129
Cyanea duvalliorum,41929,1342,2796,46067,3,23628,12987
Cyanea eleeleensis,45519,1577,2796,49892,6,16091,6807.5
Cyanea gibsonii,14068,0,2131,16199,1,16199,16199
Cyanea glabra,122865,65112,4330,192307,15,37489,10950
Cyanea grimesiana ssp. grimesiana,210668,151657,16222,378547,15,155308,14634
Cyanea grimesiana ssp. obatae,93659,1125758,12244,1231661,15,190345,107290
Cyanea hamatiflora ssp. carlsonii,322571,954,31295,354820,11,98780,20524
Cyanea hamatiflora ssp. hamatiflora,139311,72832,3764,215907,14,54489,10866
Cyanea horrida,66811,2442,2796,72049,3,27328,27142
Cyanea humboldtiana,222545,300059,5666,528270,15,136369,23182
Cyanea kolekoleensis,48697,121121,2796,172614,6,128505,11097
Cyanea koolauensis,228487,923528,5666,1157681,15,177305,72146
Cyanea kuhihewa,47285,1577,2796,51658,6,16091,7798
Cyanea kunthiana,33375,1618,2796,37789,3,19205,10160
Cyanea lanceolata,76845,918,2796,80559,3,48393,24137
Cyanea lobata,166982,5454,14505,186941,14,25010,13649.5
Cyanea longiflora,63784,1201083,9345,1274212,15,168979,109176
Cyanea magnicalyx,41263,1042,2796,45101,3,16140,15686
Cyanea mannii,185984,1577,3343,190904,14,151089,2300
Cyanea maritae,48422,1742,2796,52960,3,19623,17080
Cyanea marksii,35276,747,2131,38154,2,24558,19077
Cyanea mauiensis,25849,1042,2796,29687,3,11791,9352
Cyanea mceldowneyi,113462,1577,3930,118969,14,29096,7379.5
Cyanea munroi,36190,1042,2796,40028,3,16160,14824
Cyanea obtusa,48591,1042,2796,52429,3,19695,16727
Cyanea pinnatifida,77938,1577,14031,93546,15,16830,5533
Cyanea platyphylla,223538,5277,23460,252275,15,90738,8866
Cyanea procera,107703,1577,7902,117182,15,22250,6000
Cyanea profuga,189873,747,2796,193416,3,159195,18214
Cyanea purpurellifolia,47005,747,2796,50548,3,31585,9601
Cyanea recta,111833,1577,3343,116753,14,40500,3150
Cyanea remyi,69691,1577,4582,75850,14,20998,3243.5
Cyanea rivularis,24247,0,0,24247,1,24247,24247
Cyanea shipmanii,546049,55960,15806,617815,9,171010,59500
Cyanea solanacea,190468,1142,2796,194406,3,159295,18256
Cyanea st.-johnii,116645,694792,4964,816401,8,176545,98795
Cyanea stictophylla,316522,67657,29930,414109,15,101280,22300
Cyanea superba,84421,1394061,14748,1493230,15,170329,112108
Cyanea tritomantha,46237,8713,0,54950,2,32264,27475
Cyanea truncata,115055,1577,15437,132069,15,21218,7967
Cyanea undulata,86758,1577,7395,95730,15,16589,4000
Cyathea dryopteroides,45700,100,0,45800,12,8600,2500
Cycladenia humilis var. jonesii,21600,314675,4300,340575,4,106400,84537.5
Cyclargus (=Hemiargus) thomasi bethunebakeri,268039,49685,12947,330671,4,227369,40001
Cyclura collei,69993,69993,0,139986,1,139986,139986
Cyclura nubila nubila,0,28800,0,28800,1,28800,28800
Cyclura stejnegeri,151500,100,71000,222600,7,56500,31500
Cynomys parvidens,2526972,8033932,1947977,12508881,15,2158509,732002
Cyperus fauriei,6390,0,0,6390,1,6390,6390
Cyperus pennatiformis,109090,294,5592,114976,4,80782,12919
Cyperus trachysanthos,168864,241437,5444,415745,15,96500,16180
Cyprinella caerulea,405600,979259,57074,1441933,15,355376,64141
Cyprinella formosa,512600,162695,153560,828855,15,222929,21300
Cyprinodon bovinus,397732,500,157303,555535,15,92150,27600
Cyprinodon diabolis,2881152,4127255,41600,7050007,15,1138620,478550
Cyprinodon elegans,1152215,258000,160943,1571158,15,228625,75000
Cyprinodon macularius,1089828,3505128,1261680,5856636,15,973774,338085
Cyprinodon nevadensis mionectes,2365394,109354,23900,2498648,15,888000,71265
Cyprinodon nevadensis pectoralis,1146822,70357,17500,1234679,14,386215,53700
Cyprinodon radiosus,818457,1273500,18400,2110357,15,1109722,56880
Cyprogenia stegaria,2990713,710099,130137,3830949,15,868698,110177
Cyrtandra crenata,36762,1577,7585,45924,15,9564,1900
Cyrtandra cyaneoides,111901,23070,4707,139678,14,36438,4176
Cyrtandra dentata,70636,1427171,6390,1504197,15,189645,107790
Cyrtandra ferripilosa,32949,6118,2796,41863,3,18015,14558
Cyrtandra filipes,44204,1142,2796,48142,3,16954,16901
Cyrtandra giffardii,108533,111498,15579,235610,15,51121,16633
Cyrtandra gracilis,42889,747,2796,46432,3,16201,15786
Cyrtandra kaulantha,38736,1042,2796,42574,3,17124,16485
Cyrtandra limahuliensis,48156,24984,547,73687,14,19856,3880.5
Cyrtandra munroi,113187,6077,4030,123294,15,20059,8084
Cyrtandra nanawaleensis,17297,12624,0,29921,2,16523,14960.5
Cyrtandra oenobarba,48157,1577,2796,52530,6,12129,9453.5
Cyrtandra oxybapha,25894,1042,2796,29732,3,12380,8706
Cyrtandra paliku,62590,11577,4537,78704,6,26929,10350.5
Cyrtandra polyantha,74435,1577,14288,90300,15,17960,5757
Cyrtandra sessilis,19660,1042,2796,23498,3,8753,7928
Cyrtandra subumbellata,52846,784101,5498,842445,15,168530,47841
Cyrtandra tintinnabula,304882,44642,13207,362731,15,143700,12000
Cyrtandra viridiflora,98433,930739,5111,1034283,15,168530,68059
Cyrtandra wagneri,36001,747,0,36748,2,19391,18374
Cyrtandra waiolani,21133,747,2796,24676,3,8807,8266
Dalea foliosa,640746,221271,7855,869872,15,175440,46252
Damaliscus pygarus (=dorcas) dorcas,0,150,0,150,1,150,150
Daphnopsis hellerana,69800,100,0,69900,14,9500,4350
Deeringothamnus pulchellus,45750,3900,11095,60745,14,22200,2650
Deeringothamnus rugelii,31403,3544,13500,48447,14,16550,1875
Deinandra (=Hemizonia) conjugens,2839061,269964,25800,3134825,15,1848793,43254
Deinandra increscens ssp. villosa,491132,697556,5500,1194188,12,256134,83935.5
Delissea rhytidosperma,96058,16266,20807,133131,15,18921,7538
Delissea subcordata,117514,1445117,16597,1579228,15,201345,112498
Delissea undulata,129237,4172,20067,153476,15,33952,7500
Delphinapterus leucas,0,12046447,47400,12093847,5,3280880,2390611
Delphinium bakeri,349094,300,9500,358894,14,46500,24323.5
Delphinium luteum,181017,10521,500,192038,12,45000,9000
Delphinium variegatum ssp. kinkiense,102471,1397781,0,1500252,13,355297,70607
Deltistes luxatus,10544805,46564372,149515,57258692,15,8019777,3889677
Dendrogyra cylindricus,0,442513,0,442513,1,442513,442513
Dendroica chrysoparia,5980468,22427348,266110,28673926,15,4471850,1553371
Dermochelys coriacea,11914638,84294232,1747623,97956493,15,9992054,6900968
Desmocerus californicus dimorphus,6151004,33523126,11500,39685630,14,7714084,2571248.5
Dicerandra christmanii,94301,2500,55600,152401,15,41950,4500
Dicerandra cornutissima,30503,7129,5000,42632,13,10100,2400
Dicerandra frutescens,60650,110944,29600,201194,15,34550,14000
Dicerandra immaculata,928152,161598,100000,1189750,15,735900,24900
Dicerorhinus sumatrensis,170870,170870,0,341740,1,341740,341740
Diceros bicornis,957319,957320,0,1914639,1,1914639,1914639
Dinacoma caseyi,244518,2950,0,247468,4,218700,13064
Dionda diaboli,1597275,7922,153097,1758294,15,501577,28476
Diplacus vandenbergensis,0,388500,0,388500,1,388500,388500
Diplazium molokaiense,185927,30038,6908,222873,14,41924,13834.5
Dipodomys heermanni morroensis,502998,127405,3000,633403,14,201100,23756.5
Dipodomys ingens,1626083,2616460,80800,4323343,15,668922,300272
Dipodomys merriami parvus,1012474,2331919,5700,3350093,15,480917,232004
Dipodomys nitratoides exilis,641882,820793,5800,1468475,15,176901,88350
Dipodomys nitratoides nitratoides,1296313,1598904,146200,3041417,15,781568,121275
Dipodomys stephensi (incl. D. cascus),711859,3467388,20800,4200047,15,538249,265387
Discus macclintocki,587800,22793,32020,642613,15,158000,24808
Dodecahema leptoceras,56048,1303237,7200,1366485,15,212715,86330
Doryopteris angelica,82347,1577,5253,89177,6,39040,9975.5
Doryopteris takeuchii,19226,623,2796,22645,3,8458,7603
Dromus dromas,564586,311409,37647,913642,15,198451,12680
Drosophila aglaia,104931,0,0,104931,10,36365,9807.5
Drosophila differens,109348,0,0,109348,10,36365,9121.5
Drosophila digressa,14298,0,0,14298,2,8873,7149
Drosophila hemipeza,106299,0,0,106299,10,36365,8543.5
Drosophila heteroneura,116463,6572,0,123035,10,36365,9171.5
Drosophila montgomeryi,101389,828614,0,930003,10,289678,50223
Drosophila mulli,99732,1095,0,100827,10,36365,7357.5
Drosophila musaphilia,35698,38211,0,73909,4,32176,14681
Drosophila neoclavisetae,92105,0,0,92105,10,36365,6471
Drosophila obatai,97361,101163,0,198524,10,84609,9621.5
Drosophila ochrobasis,103655,1095,0,104750,10,36365,7606
Drosophila sharpi,60606,38211,0,98817,6,35893,16024
Drosophila substenoptera,101361,828535,0,929896,10,289678,51183.5
Drosophila tarphytrichia,93619,0,0,93619,10,36365,6978
Drymarchon corais couperi,6007887,13027963,266147,19301997,15,2460953,1344332
Dryopteris crinalis var. podosorus,73678,1412,2796,77886,6,18635,14283.5
Dubautia herbstobatae,71096,1307965,4317,1383378,15,176656,107198
Dubautia imbricata imbricata,46487,1577,2796,50860,6,11684,8659.5
Dubautia kalalauensis,75811,1577,5901,83289,6,17429,13815.5
Dubautia kenwoodii,42667,1577,2796,47040,6,16091,7057.5
Dubautia latifolia,49597,2677,17594,69868,14,11444,4162.5
Dubautia pauciflorula,100468,1577,5776,107821,14,23089,4532
Dubautia plantaginea magnifolia,38601,1577,2796,42974,6,12750,6557.5
Dubautia plantaginea ssp. humilis,81065,954,6749,88768,14,17306,7950
Dubautia waialealae,82155,1577,2796,86528,6,20551,13687
Dudleya abramsii ssp. parva,54599,10281,600,65480,15,16908,3000
Dudleya cymosa ssp. marcescens,50843,10970,500,62313,13,20362,1850
Dudleya cymosa ssp. ovatifolia,374808,12805,700,388313,13,319075,3436
Dudleya nesiotica,13951,42840,0,56791,9,14082,7000
Dudleya setchellii,313170,221723,0,534893,12,233500,26999.5
Dudleya stolonifera,33767,0,0,33767,4,27161,3260
Dudleya traskiae,50287,51338,0,101625,12,21607,5816
Dudleya verityi,451593,15781,0,467374,13,287050,2250
Echinacea laevigata,1159817,1240255,151714,2551786,15,286925,188654
Echinacea tennesseensis,386400,34491,1117,422008,11,157350,21110
Echinocactus horizonthalonius var. nicholii,66151,146403,15450,228004,15,59000,7406
Echinocereus chisoensis var. chisoensis,14300,150500,5800,170600,15,64400,5450
Echinocereus fendleri var. kuenzleri,42600,2084365,0,2126965,15,1117150,78100
Echinocereus reichenbachii var. albertii,118150,15471,20840,154461,15,19291,10300
Echinocereus triglochidiatus var. arizonicus,67545,136707,20700,224952,14,98095,5650
Echinocereus viridiflorus var. davisii,13700,500,14450,28650,11,9400,650
Echinomastus erectocentrus var. acunensis,12100,101700,5000,118800,2,64800,59400
Echinomastus mariposensis,3400,26810,18644,48854,14,8892,2600
Elaphoglossum serpens,45400,100,0,45500,14,8100,2500
Elaphrus viridis,91172,1313200,6500,1410872,14,1301400,2844
Elassoma alabamae,29300,0,0,29300,2,21300,14650
Elephas maximus,1904973,2026673,0,3931646,1,3931646,3931646
Eleutherodactylus cooki,401500,6156,0,407656,15,124250,10900
Eleutherodactylus jasperi,62400,52700,0,115100,13,24500,5500
Eleutherodactylus juanariveroi,11100,1900,0,13000,2,7000,6500
Elimia crenatella,85200,5381,0,90581,12,18504,5850
Elliptio chipolaensis,370024,818879,500,1189403,15,193200,73260
Elliptio spinosa,17700,55443,4500,77643,4,35793,18475
Elliptio steinstansana,668200,288956,360269,1317425,15,213262,74082
Elliptoideus sloatianus,1277224,1042778,40500,2360502,15,287586,159015
Empetrichthys latos,874014,163826,33350,1071190,15,148873,57672
Empidonax traillii extimus,11374943,185197428,2102799,198675170,15,23157345,12297617
Enceliopsis nudicaulis var. corrugata,338901,54513,0,393414,12,106176,19650
Enhydra lutris kenyoni,4056711,1605417,29205,5691333,11,783711,528149
Enhydra lutris nereis,3246138,11941373,205200,15392711,15,1280387,745766
Epicrates inornatus,503500,724861,0,1228361,15,153073,77074
Epicrates monensis granti,210100,49422,29256,288778,13,47128,25828
Epicrates monensis monensis,132500,100,0,132600,15,27500,8000
Epioblasma brevidens,913104,562531,92305,1567940,15,259168,33701
Epioblasma capsaeformis,1416285,394555,124563,1935403,15,346600,30375
Epioblasma florentina curtisii,131850,86644,43200,261694,15,79300,7095
Epioblasma florentina florentina,42500,17160,0,59660,14,15000,2633
Epioblasma florentina walkeri (=E. walkeri),1277449,240945,78593,1596987,15,271377,100815
Epioblasma metastriata,103700,234085,33475,371260,15,147989,15200
Epioblasma obliquata obliquata,456550,292485,28999,778034,15,108282,23824
Epioblasma obliquata perobliqua,373150,198414,9884,581448,15,111600,27200
Epioblasma othcaloogensis,93600,239066,30500,363166,15,145989,15700
Epioblasma penita,88100,55374,19175,162649,15,51000,4943
Epioblasma torulosa gubernaculum,61418,10147,3500,75065,15,15900,2600
Epioblasma torulosa rangiana,1072614,2370227,290156,3732997,15,465925,254073
Epioblasma torulosa torulosa,119703,115715,2471,237889,15,70000,6232.5
Epioblasma triquetra,364842,2075525,48659,2489026,4,1002972,597479
Epioblasma turgidula,42400,13968,0,56368,14,9652,1956
Equus grevyi,0,300,0,300,1,300,300
Equus hemionus,250,12500,0,12750,1,12750,12750
Equus przewalskii,0,49200,0,49200,1,49200,49200
Eragrostis fosbergii,46515,8207,3443,58165,14,14054,3303
Eremalche kernensis,181852,151927,4000,337779,15,58102,15165
Eremichthys acros,717031,246845,22400,986276,15,153600,61000
Eremophila alpestris strigata,714291,2815486,18000,3547777,2,2151512,1773888.5
Eretmochelys imbricata,7920876,50570152,2053147,60544175,15,6763446,3888053
Eriastrum densifolium ssp. sanctorum,57024,1356238,20420,1433682,14,221966,85515.5
Eriastrum hooveri,13870,44560,0,58430,4,29770,10550
Erigeron decumbens,1923490,1523618,0,3447108,15,843700,185237
Erigeron maguirei,151400,318926,400,470726,11,139200,34000
Erigeron parishii,76103,520103,0,596206,15,179230,28440
Erigeron rhizomatus,48164,62978,10200,121342,14,17300,8231
Erignathus barbatus nauticus,0,250150,0,250150,1,250150,250150
Erimonax monachus,1585877,402419,129884,2118180,11,303955,12500
Erimystax cahni,212686,264927,7500,485113,15,179240,15733
Erinna newcombi,487719,264,0,487983,14,128500,14291.5
Eriodictyon altissimum,340801,9800,0,350601,15,156848,6797
Eriodictyon capitatum,78136,584693,200,663029,14,308000,13995.5
Eriogonum apricum (incl. var. prostratum),79491,6100,44300,129891,10,63000,9650
Eriogonum codium,30349,4267,800,35416,2,18494,17708
Eriogonum gypsophilum,51900,340720,0,392620,14,131600,16000
Eriogonum kennedyi var. austromontanum,42803,574214,0,617017,12,265935,26516.5
Eriogonum longifolium var. gnaphalifolium,148104,1011135,26600,1185839,14,316580,50700
Eriogonum ovalifolium var. vineum,86872,553027,500,640399,14,175230,21750
Eriogonum ovalifolium var. williamsiae,418404,193276,900,612580,15,125200,31200
Eriogonum pelinophilum,73051,287407,7055,367513,15,74036,19750
Eriophyllum latilobum,195758,2968,0,198726,10,106450,10996.5
Eryngium aristulatum var. parishii,2409616,1280149,4300,3694065,15,1801411,95200
Eryngium constancei,28517,400,0,28917,9,10235,2079
Eryngium cuneifolium,104100,130311,35616,270027,15,48384,16000
Erysimum capitatum var. angustatum,709423,30400,0,739823,11,231500,57450
Erysimum menziesii,574711,963600,1000,1539311,15,327180,88000
Erysimum teretifolium,236292,200,0,236492,13,104000,9740
Erythronium propullans,132900,20504,55100,208504,15,31844,14600
Eschrichtius robustus,1020,4058271,0,4059291,9,1975402,132510
Etheostoma boschungi,292300,237508,51134,580942,15,144737,18346
Etheostoma chermocki,212300,6735,4100,223135,14,154455,4204
Etheostoma chienense,353800,17077,400,371277,15,67500,19100
Etheostoma etowahae,3863500,196767,74650,4134917,15,1114500,139350
Etheostoma fonticola,2827173,133359,5900,2966432,14,655364,80900
Etheostoma moorei,172000,12128,2500,186628,5,79396,24661
Etheostoma nianguae,2027076,69019,2489800,4585895,14,1041457,293682
Etheostoma nuchale,159700,19629,10167,189496,15,28477,12000
Etheostoma okaloosae,1364720,10792804,0,12157524,15,2245000,633000
Etheostoma percnurum,665471,1765431,21360,2452262,15,1337249,30210
Etheostoma phytophilum,6800,2599,0,9399,5,6335,850
Etheostoma rubrum,41000,31604,41400,114004,14,15733,10320
Etheostoma scotti,2954500,420683,66900,3442083,15,576988,145000
Etheostoma sellare,106590,2621,0,109211,9,42800,9408
Etheostoma susanae,60800,11116,8860,80776,5,23684,18630
Etheostoma wapiti,677500,3264479,42065,3984044,15,792200,47068
Eubalaena australis,0,23044,517,23561,5,19050,1000
Eubalaena glacialis,3000,50350074,235493,50588567,5,10958108,9905912
Eubalaena japonica,0,4975160,0,4975160,5,2762940,570759
Eucyclogobius newberryi,5410907,3455539,37000,8903446,15,944722,607256
Eudyptes chrysocome,4793,0,0,4793,1,4793,4793
Eugenia haematocarpa,67300,100,0,67400,14,13000,3750
Eugenia koolauensis,116862,952593,10883,1080338,15,182934,69133
Eugenia woodburyana,210400,300,0,210700,14,90500,8750
Eumeces egregius lividus,605394,696567,0,1301961,15,394740,34708
Eumetopias jubatus,131578,531988654,12232169,544352401,15,55998075,16568504
Eumops floridanus,645018,414579,57576,1117173,2,801684,558586.5
Euphilotes battoides allyni,1175203,2118172,700,3294075,15,671750,112002
Euphilotes enoptes smithi,1046744,303504,0,1350248,15,192360,85500
Euphorbia celastroides var. kaenana,14058,160333,0,174391,1,174391,174391
Euphorbia deppeana,4891,0,0,4891,1,4891,4891
Euphorbia eleanoriae,11231,0,0,11231,1,11231,11231
Euphorbia haeleeleana,134175,240746,28731,403652,15,81375,17738
Euphorbia halemanui,5148,0,0,5148,1,5148,5148
Euphorbia herbstii,7295,160333,0,167628,1,167628,167628
Euphorbia kuwaleana,4891,28917,0,33808,1,33808,33808
Euphorbia remyi var. kauaiensis,9765,0,0,9765,1,9765,9765
Euphorbia remyi var. remyi,15771,0,0,15771,1,15771,15771
Euphorbia rockii,5317,160333,0,165650,1,165650,165650
Euphorbia skottsbergii var. skottsbergii,25019,0,0,25019,1,25019,25019
Euphorbia telephioides,730928,18343,13200,762471,14,421782,20583.5
Euphydryas editha bayensis,786020,646547,0,1432567,14,227911,88119
Euphydryas editha quino (=E. e. wrighti),3722294,1974006,1503000,7199300,14,2117111,283655
Euphydryas editha taylori,435933,986782,35000,1457715,2,935487,728857.5
Euphyllia paradivisa,0,349861,0,349861,1,349861,349861
Euproserpinus euterpe,247297,216266,0,463563,15,69544,34403
Eurycea chisholmensis,47500,3776,0,51276,2,42576,25638
Eurycea nana,808896,33389,63933,906218,15,232499,26605
Eurycea naufragia,166000,49190,0,215190,2,174590,107595
Eurycea sosorum,2882133,786338,59923,3728394,15,1884500,93850
Eurycea tonkawae,308000,75150,0,383150,3,250550,99400
Eurycea waterlooensis,115000,5973,0,120973,3,75550,32223
Eutrema penlandii,100538,158619,7055,266212,15,84425,3509
Exocarpos luteolus,227144,3925,15742,246811,15,68910,5125
Falco femoralis septentrionalis,2265600,13341806,233905,15841311,15,1539057,495328
Festuca molokaiensis,25081,847,2796,28724,3,11172,9008
Flueggea neowawraea,368787,1658165,55796,2082748,15,226845,143661
Formicivora erythronotos,390,0,0,390,1,390,390
Frankenia johnstonii,378000,230081,62654,670735,15,233500,23700
Fremontodendron californicum ssp. decumbens,242129,171110,1000,414239,14,89983,22773.5
Fremontodendron mexicanum,144441,129869,0,274310,11,129339,7500
Fritillaria gentneri,1383649,4415013,21529,5820191,15,890036,353383
Fulica americana alai,4026820,4021596,50928,8099344,15,2319024,347158
Fusconaia burkei,13869,53729,0,67598,3,26256,22746
Fusconaia cor,591655,1678572,5600,2275827,15,638000,31710
Fusconaia cuneolus,641886,1729065,10500,2381451,15,657000,40816.5
Fusconaia escambia,17858,136166,0,154024,3,84804,50401
Fusconaia rotulata,2700,66353,0,69053,3,29355,21251
Gahnia lanaiensis,52947,5330,747,59024,13,15731,3600
Galactia smallii,104300,11429,7000,122729,15,38100,3800
Galium buxifolium,43464,118340,0,161804,14,32800,7166.5
Galium californicum ssp. sierrae,281759,2156950,420,2439129,14,1842000,35695
Gallinula chloropus guami,791192,2156084,27900,2975176,15,1000078,70680
Gallinula galeata sandvicensis,149586,783149,0,932735,1,932735,932735
Gambelia silus,2335578,3017304,67600,5420482,15,809255,359762
Gambusia gaigei,276748,112900,8950,398598,15,65772,17500
Gambusia georgei,53100,17573,8950,79623,15,50000,1020
Gambusia heterochir,374113,0,8950,383063,13,222500,6300
Gambusia nobilis,346031,334100,52117,732248,15,183700,38200
Gammarus acherondytes,203300,13291,60728,277319,15,95500,8464
Gammarus desperatus,114122,24100,32488,170710,11,62688,13881
Gammarus hyalleloides,27000,3000,0,30000,3,20500,7500
Gammarus pecos,1000,5000,1400,7400,2,4900,3700
Gardenia brighamii,463596,2687,33267,499550,15,180728,17009
Gardenia mannii,281946,1023075,13377,1318398,15,183571,74063
Gasterosteus aculeatus williamsoni,779168,1067428,88100,1934696,15,314351,89093
Gaura neomexicana var. coloradensis,289935,1175437,8950,1474322,15,200175,89157
Gazella dama,0,150,0,150,1,150,150
Gazella leptoceros,0,150,0,150,1,150,150
Geocarpon minimum,952719,39068,115990,1107777,15,514400,20000
Geranium arboreum,158187,279584,9951,447722,14,70805,30108.5
Geranium hanaense,26400,3444,2796,32640,3,14582,9658
Geranium hillebrandii,24702,1042,2796,28540,3,11572,8544
Geranium kauaiense,116744,1577,4182,122503,6,30830,19928
Geranium multiflorum,98351,146750,4867,249968,15,43902,13938
Gesneria pauciflora,86000,100,0,86100,14,42000,3500
Geum radiatum,82450,125404,4595,212449,15,36670,11547
Gila bicolor ssp.,848405,478407,37666,1364478,15,475243,24602.5
Gila bicolor ssp. mohavensis,485252,370707,7500,863459,4,475243,141413.5
Gila bicolor ssp. snyderi,152495,56300,0,208795,5,67500,47140
Gila boraxobius,1258089,220400,19126,1497615,15,705319,63624
Gila cypha,5068178,92299196,5088364,102455738,15,13409098,6670006
Gila ditaenia,65894,482810,204380,753084,15,314400,27000
Gila elegans,9222287,64573388,3791374,77587049,15,6700373,5733982
Gila intermedia,339927,6693973,731180,7765080,10,2764031,605988
Gila nigrescens,374084,22900,29803,426787,15,66167,9537
Gila purpurea,437903,71460,169880,679243,15,128150,22100
Gila robusta,1592392,177973,35000,1805365,15,474975,81662
Gila robusta jordani,1592392,177973,35000,1805365,15,474975,81662
Gila seminuda (=robusta),5072644,1705700,3156723,9935067,15,890379,715062
Gilia tenuiflora ssp. arenaria,252395,625393,0,877788,15,181200,36754
Gilia tenuiflora ssp. hoffmannii,116223,107980,0,224203,13,113922,7714
Glaucidium brasilianum cactorum,2001685,1406663,562000,3970348,5,1607900,657590
Glaucomys sabrinus coloratus,437557,612855,182274,1232686,15,186604,71000
Glaucomys sabrinus fuscus,534636,1563135,113159,2210930,11,504638,175807
Glaucopsyche lygdamus palosverdesensis,881319,2651023,3200,3535542,15,980750,195055
Goetzea elegans,130000,4300,0,134300,14,22500,9500
Gonocalyx concolor,9100,200,0,9300,1,9300,9300
Gopherus agassizii,36471965,183791586,2320540,222584091,15,33677623,7958057
Gopherus polyphemus,3804500,37203478,356437,41364415,15,13348459,2102100
Gorilla gorilla,3685636,3685636,0,7371272,1,7371272,7371272
Gouania hillebrandii,47099,1577,6671,55347,15,10605,2387
Gouania meyenii,88238,1577,23218,113033,14,20052,5841
Gouania vitifolia,169068,1082133,28786,1279987,15,189182,119293
Graptemys flavimaculata,177792,111086,22000,310878,15,44392,15128
Graptemys oculifera,92000,454241,40584,586825,15,277891,12296
Grindelia fraxinipratensis,172552,14800,0,187352,3,126209,30783
Grus americana,15871475,42518718,1984912,60375105,15,5987523,791512
Grus canadensis pulla,5531920,369735,5800,5907455,15,672740,428100
Grus monacha,0,1640,0,1640,1,1640,1640
Grus nigricollis,0,1640,0,1640,1,1640,1640
Grus vipio,0,1400,0,1400,1,1400,1400
Gymnoderma lineare,201657,37126,17815,256598,15,37300,15400
Gymnogyps californianus,20736120,9740961,2877942,33355023,15,3385702,715644.5
Hackelia venusta,331233,190106,4100,525439,14,110486,29963
Haliaeetus albicilla groenlandicus,0,14000,0,14000,1,14000,14000
Haliaeetus leucocephalus,16855408,46693050,8777116,72325574,12,13462328,7251633.5
Haliotis cracherodii,0,7030751,0,7030751,5,1666933,1638873
Haliotis sorenseni,20200,14810942,21000,14852142,15,6713710,330883
Halophila johnsonii,12300,19514221,8700,19535221,15,5695822,730864
Hamiota australis,14769,124214,0,138983,3,89106,30611
Haplostachys haplostachya,141232,2396662,13651,2551545,15,453910,166277
Harperocallis flava,217272,613126,4400,834798,15,162662,45472
Harpia harpyja,250,0,0,250,1,250,250
Harrisia portoricensis,154300,300,0,154600,14,38800,6750
Hedeoma todsenii,47500,716911,0,764411,14,160946,39125
Hedyotis purpurea var. montana,58200,17500,7327,83027,14,15500,5141
Helenium virginicum,137555,60037,48600,246192,15,54800,17700
Helianthemum greenei,217659,94500,200,312359,15,112735,7600
Helianthus eggertii,145000,666704,8246,819950,5,259100,150950
Helianthus paradoxus,901334,326713,23334,1251381,15,282242,69400
Helianthus schweinitzii,549492,381768,184132,1115392,15,213744,67353
Helianthus verticillatus,66000,600,0,66600,2,45600,33300
Helminthoglypta walkeriana,1636803,139311,2500,1778614,15,208500,115638
Helonias bullata,927406,775884,97564,1800854,15,256185,105192
Hemignathus hanapepe,3920,0,0,3920,1,3920,3920
Hemignathus wilsoni,13276,44915,0,58191,1,58191,58191
Hemistena lata,628170,2693619,22233,3344022,15,715813,73861.5
Heraclides aristodemus ponceanus,745810,135106,0,880916,15,460327,27430
Herpailurus (=Felis) yagouaroundi cacomitli,661950,2134040,13350,2809340,15,907675,85567
Herpailurus (=Felis) yagouaroundi tolteca,45200,950,44780,90930,11,45000,2480
Hesperia dacotae,184787,123703,6200,314690,1,314690,314690
Hesperia leonardus montana,146026,237064,0,383090,14,69853,23259.5
Hesperolinon congestum,187656,106313,0,293969,15,69500,13300
Hesperomannia arborescens,213615,958720,9870,1182205,15,175875,74520
Hesperomannia arbuscula,135825,1219771,14262,1369858,15,173522,115353
Hesperomannia lydgatei,57330,1577,3343,62250,14,9787,4550.5
Heterelmis comalensis,665788,45694,24482,735964,15,207377,38359
Hexastylis naniflora,251924,1208837,556873,2017634,15,630466,54612
Hibiscadelphus distans,52163,31738,25252,109153,15,23691,6964
Hibiscadelphus giffardianus,56980,99745,5675,162400,15,21963,11537
Hibiscadelphus hualalaiensis,180996,78103,23630,282729,15,104962,14274
Hibiscadelphus woodii,59261,1577,3660,64498,15,10820,3500
Hibiscus arnottianus ssp. immaculatus,346872,22174,4707,373753,14,173664,5904
Hibiscus brackenridgei,420553,1799191,48647,2268391,15,385494,167282
Hibiscus clayi,59575,2087,20734,82396,15,10770,5351
Hibiscus dasycalyx,36000,400,26255,62655,2,41555,31327.5
Hibiscus waimeae ssp. hannerae,80142,45267,18366,143775,14,35146,5506
Himantopus mexicanus knudseni,3964589,5035673,65628,9065890,14,2258563,465257.5
Hoffmannseggia tenella,351250,98255,26850,476355,15,93100,24291
Holocarpha macradenia,447472,120300,3500,571272,15,115369,29500
Howellia aquatilis,1870610,1313337,94490,3278437,15,539612,179252
Hudsonia montana,81600,21500,1558,104658,13,28000,9000
Huperzia mannii,83637,86689,5931,176257,15,21473,13330
Huperzia nutans,46780,465081,2796,514657,4,168747,121771.5
Hybognathus amarus,10739776,135044959,518506,146303241,15,12451853,8357200
Hylobates spp. (including Nomascus),521200,522400,0,1043600,1,1043600,1043600
Hymenoxys herbacea,164300,59199,16368,239867,15,57870,11331
Hymenoxys texana,489200,891946,27345,1408491,15,213188,79170
Hypericum cumulicola,138201,4900,82900,226001,15,59100,11900
Hypomesus transpacificus,15964258,71563969,1255000,88783227,15,17263815,2881714
Icaricia (Plebejus) shasta charlestonensis,305700,0,700,306400,2,305700,153200
Icaricia icarioides fenderi,5400790,2104092,0,7504882,15,1160894,467199
Icaricia icarioides missionensis,380350,2111845,0,2492195,15,347222,152100
Ictalurus pricei,604338,149510,156080,909928,15,299150,25600
Ilex cookii,50500,23000,0,73500,14,31400,1750
Ilex sintenisii,55600,1016,0,56616,14,11700,2000
Iliamna corei,101046,28200,13700,142946,15,46500,6000
Ipomopsis polyantha,713215,66430,7055,786700,5,543032,64000
Ipomopsis sancti-spiritus,84675,16484,0,101159,7,31000,15000
Iris lacustris,274500,116943,23250,414693,15,98536,24800
Ischaemum byrone,61407,97047,6462,164916,15,24515,10400
Isodendrion hosakae,62372,2146066,7486,2215924,15,453510,158548
Isodendrion laurifolium,80119,13577,26586,120282,15,14900,9408
Isodendrion longifolium,81842,278781,21463,382086,15,101736,11884
Isodendrion pyrifolium,361693,145287,15404,522384,15,146626,7293
Isoetes louisianensis,56600,1509384,8600,1574584,15,269670,101500
Isoetes melanospora,48600,21246,15000,84846,15,18100,4400
Isoetes tegetiformans,40300,11497,15000,66797,15,10400,3120
Isopora crateriformis,0,349861,0,349861,1,349861,349861
Isotria medeoloides,563461,3204513,98986,3866960,15,788008,182532
Ivesia kingii var. eremica,287461,20713,0,308174,11,120094,23078
Ivesia webberi,291884,34160,1000,327044,2,165420,163522
Jacquemontia reclinata,290600,15171,71400,377171,15,79600,12050
Juglans jamaicensis,62100,1200,0,63300,13,10000,5000
Justicia cooleyi,23250,10194,9600,43044,11,8300,3600
Juturnia kosteri,71053,22000,6650,99703,11,13576,10100
Kadua cookiana,5040,0,0,5040,1,5040,5040
Kadua cordata remyi,13561,0,0,13561,1,13561,13561
Kadua coriacea,47082,942314,2796,992192,4,320182,277601
Kadua degeneri,32398,476277,5592,514267,4,178787,118099.5
Kadua laxiflora,16089,100,0,16189,1,16189,16189
Kadua parvula,26492,261305,2796,290593,4,139262,69123.5
Kanaloa kahoolawensis,111331,1987,6526,119844,15,27773,5033
Keysseria (=Lagenifera) erici,84281,789,2796,87866,6,21856,13000
Keysseria (=Lagenifera) helenae,75721,789,2796,79306,6,19928,13220
Kobus leche,500,450,0,950,1,950,950
Kokia cookei,89801,1987,10165,101953,15,19119,4810
Kokia drynarioides,168618,559244,52270,780132,14,105469,50093.5
Kokia kauaiensis,96697,11415,21290,129402,15,30239,3600
Korthalsella degeneri,20201,747,2796,23744,3,8458,7645
Labordia cyrtandrae,148652,1016375,12388,1177415,15,292655,49349
Labordia helleri,45071,1577,4079,50727,6,12967,8022
Labordia lydgatei,137736,44829,6838,189403,15,39420,9179
Labordia pumila,74607,1577,2796,78980,6,18523,13062
Labordia tinifolia var. lanaiensis,78191,6077,6844,91112,14,17870,3450
Labordia tinifolia var. wahiawaensis,92070,1577,5976,99623,15,21589,3500
Labordia triflora,244576,1577,4782,250935,15,159195,4800
Lampsilis abrupta,2737204,4209861,488545,7435610,15,1180916,398669
Lampsilis altilis,564950,373851,46111,984912,15,210145,44137
Lampsilis higginsii,3435050,8312862,611242,12359154,15,1302660,804799
Lampsilis perovalis,373550,317260,20704,711514,15,194228,27555
Lampsilis powellii,317400,958067,16525,1291992,9,791720,36000
Lampsilis rafinesqueana,103069,327669,3811,434549,2,250463,217274.5
Lampsilis streckeri,312300,98786,12200,423286,13,75827,30000
Lampsilis subangulata,1623751,321737,37782,1983270,14,280725,126752
Lampsilis virescens,337700,836476,4000,1178176,15,526000,9262
Lanius ludovicianus mearnsi,318769,32631163,2600,32952532,15,4453692,2405580
Lanx sp.,1128104,286635,6973,1421712,15,203174,101542
Lasiurus cinereus semotus,4435184,5939970,102100,10477254,15,1515820,657465
Lasmigona decorata,2965412,1409072,1982874,6357358,15,991892,354860
Lasthenia burkei,545823,4327149,10100,4883072,15,3819500,36661
Lasthenia conjugens,1166780,3343198,6800,4516778,15,1855592,139236
Layia carnosa,364791,1561133,700,1926624,15,312913,121947
Leavenworthia crassa,50400,1400,0,51800,2,50500,25900
Leavenworthia exigua laciniata,95500,10180,0,105680,2,86220,52840
Leavenworthia texana,16500,300,0,16800,2,9600,8400
Lemiox rimosus,233266,1099602,1100,1333968,5,731933,11000
"Lemuridae (incl. genera Lemur, Phaner, Hapalemur, Lepilemur, Microcebus, Allocebus, Cheirogaleus, Varecia)",0,3900,0,3900,1,3900,3900
Leontopithecus spp.,0,6600,0,6600,1,6600,6600
Leopardus (=Felis) pardalis,2424153,3749247,505282,6678682,15,1016946,291026
Leopardus (=Felis) tigrinus,0,1128024,0,1128024,1,1128024,1128024
Leopardus (=Felis) wiedii,0,150,0,150,1,150,150
Lepanthes eltoroensis,56700,200,0,56900,14,11800,1750
Lepidium arbuscula,130873,370412,11767,513052,15,100912,18851
Lepidium barnebyanum,65700,4585,400,70685,15,22000,3000
Lepidium papilliferum,1336214,970326,51217,2357757,3,1045487,674205
Lepidochelys kempii,5523997,61511605,2359164,69394766,15,6664434,4461620
Lepidochelys olivacea,1613132,33762774,500,35376406,15,5202856,1086114.5
Lepidomeda albivallis,1270592,102869,48950,1422411,15,219863,65858
Lepidomeda mollispinis pratensis,518633,643034,27500,1189167,15,430000,49168
Lepidomeda vittata,1031060,549660,333080,1913800,15,474080,80400
Lepidurus packardi,6792164,11019351,7000,17818515,14,3431456,1071889.5
Leptocereus grantianus,88600,1190,0,89790,14,15100,4950
Leptodea leptodon,1222519,666915,264499,2153933,14,390100,134628
Leptonycteris curasoae yerbabuenae,790081,6154403,509572,7454056,15,1476106,430488
Leptonycteris nivalis,139200,931999,55405,1126604,15,197100,51682
Leptoptilos dubius,794,0,0,794,1,794,794
Leptoxis ampla,53000,6692,1798,61490,13,15000,2100
Leptoxis foremani,8950,6484,5000,20434,6,7600,2125
Leptoxis plicata,368700,5128,3000,376828,12,184000,11250
Leptoxis taeniata,111400,11312,0,122712,12,28220,8950
Lepyrium showalteri,194900,5161,1798,201859,10,166591,1838.5
Lespedeza leptostachya,554800,62605,104234,721639,15,84000,47820
Lesquerella congesta,146795,221801,7055,375651,15,78762,19151
Lesquerella kingii ssp. bernardina,90553,412853,0,503406,14,174230,16964.5
Lesquerella lyrata,17000,3348,0,20348,9,9000,900
Lesquerella pallida,294320,118700,15836,428856,15,87500,19000
Lesquerella perforata,213550,64179,1790,279519,15,45077,15790
Lesquerella thamnophila,164370,290797,39810,494977,15,229000,17021
Lesquerella tumulosa,55966,70927,400,127293,15,37750,3000
Lessingia germanorum (=L.g. var. germanorum),57292,143210,0,200502,13,41934,16000
Liatris helleri,37900,50766,7970,96636,15,9960,6578
Liatris ohlingerae,137170,6216,83875,227261,15,38400,11000
Lilaeopsis schaffneriana var. recurva,568112,4494946,24450,5087508,14,808674,331406.5
Lilium occidentale,1844317,733338,32500,2610155,15,530513,140210
Lilium pardalinum ssp. pitkinense,88769,400,0,89169,9,26680,5500
Limnanthes floccosa ssp. californica,659624,484155,5000,1148779,15,413694,57860
Limnanthes pumila grandiflora,32500,0,0,32500,1,32500,32500
Limnanthes vinculans,440797,500200,15200,956197,14,483660,29265
Lindera melissifolia,703832,8263296,184231,9151359,15,1652480,387310
Linum carteri carteri,86737,7600,1200,95537,1,95537,95537
Lioplax cyclostomaformis,60900,19715,4298,84913,12,15198,7323
Lipochaeta fauriei,49081,3414,16946,69441,15,12500,4325
Lipochaeta lobata var. leptophylla,60101,46818,3343,110262,14,19800,8391.5
Lipochaeta micrantha,69768,954,10846,81568,14,15272,4050
Lipochaeta venosa,103149,2144213,7227,2254589,15,452510,164886
Lipochaeta waimeaensis,67295,8073,16446,91814,15,21969,3500
Lirceus usdagalun,347765,5100,9250,362115,15,53600,21250
Lithophragma maximum,55643,1686160,0,1741803,13,400489,73051
Lobelia koolauensis,5031,160333,2131,167495,1,167495,167495
Lobelia monostachya,98356,1577,14683,114616,15,18552,6343
Lobelia niihauensis,106516,293931,10965,411412,15,77931,18515
Lobelia oahuensis,237826,906720,11534,1156080,15,178246,74553
Lomatium bradshawii,1530814,736182,1300,2268296,15,300116,139367
Lomatium cookii,820736,947491,21429,1789656,13,310689,130678
Loxioides bailleui,8508048,11560592,1085086,21153726,15,3794164,1080830
Loxodonta africana,5574252,5619652,0,11193904,1,11193904,11193904
Loxops caeruleirostris,681722,119667,1000,802389,6,170210,136592.5
Loxops coccineus,1743991,2022496,14374,3780861,15,1419031,60988
Loxops ochraceus,3646,1000,3000,7646,1,7646,7646
Lupinus aridorum,303504,18374,175800,497678,14,124250,25825
Lupinus nipomensis,154199,0,0,154199,12,53798,6325.5
Lupinus sulphureus ssp. kincaidii,1026040,1286032,1300,2313372,4,761052,610093.5
Lupinus tidestromii,56464,264644,200,321308,15,70000,13839
Lycaeides argyrognomon lotis,103085,300,0,103385,12,41000,4240
Lycaeides melissa samuelis,4379212,7100392,3511909,14991513,15,1729106,942887
Lycaon pictus,20000,20000,0,40000,1,40000,40000
Lynx (=Felis) rufus escuinapae,0,1000,0,1000,1,1000,1000
Lynx canadensis,15701611,36764751,7451211,59917573,15,6556340,4057162
Lyonia truncata var. proctorii,63800,470,0,64270,12,11000,6000
Lysimachia asperulaefolia,363500,2234122,49693,2647315,14,418853,185032
Lysimachia daphnoides,110054,1577,3305,114936,6,31337,17177.5
Lysimachia filifolia,48025,1577,5841,55443,14,10821,3740
Lysimachia iniki,60988,1577,2796,65361,6,17517,9987.5
Lysimachia lydgatei,77954,1577,4492,84023,14,19083,4082.5
Lysimachia maxima,79759,3577,9126,92462,15,17306,5079
Lysimachia pendens,72046,1577,3605,77228,6,18470,14233
Lysimachia scopulensis,46167,1577,4215,51959,6,16058,7656.5
Lysimachia venosa,52805,1577,2796,57178,6,16059,8145.5
Macbridea alba,91500,419849,9600,520949,15,122562,29600
Macrocephalon maleo,47799,47799,0,95598,1,95598,95598
Malacothamnus clementinus,72983,2253598,0,2326581,14,513552,101784.5
Malacothamnus fasciculatus var. nesioticus,115589,92433,0,208022,12,74777,8271.5
Malacothrix indecora,24778,74019,0,98797,14,28639,5195
Malacothrix squalida,25603,23201,0,48804,8,29464,1551.5
Manduca blackburni,1456512,299718,869,1757099,15,255861,106078
Manihot walkerae,308550,255199,29930,593679,15,255600,25000
Manis temminckii,10000,0,0,10000,1,10000,10000
Margaritifera hembeli,1805500,537624,53912,2397036,15,466356,120850
Margaritifera marrianae,46600,3344,3500,53444,3,46600,4435
Marshallia mohrii,68700,51354,72200,192254,14,39200,11350
Marsilea villosa,98631,122163,6936,227730,15,48797,16653
Masticophis lateralis euryxanthus,2901816,1604066,2000,4507882,15,875360,235560
Meda fulgida,1049053,11657674,1461148,14167875,15,3436727,733174
Medionidus acutissimus,208850,430037,39775,678662,15,154489,36900
Medionidus parvulus,175000,242111,40075,457186,15,149989,21399
Medionidus penicillatus,1080370,329509,37000,1446879,15,263400,88708
Medionidus simpsonianus,721523,180710,27000,929233,15,176600,57000
Megalagrion leptodemas,22079,0,0,22079,3,7608,7321
Megalagrion nesiotes,102192,0,0,102192,6,32773,15366
Megalagrion nigrohamatum nigrolineatum,86399,0,0,86399,3,50185,23499
Megalagrion oceanicum,39106,0,0,39106,3,22992,8754
Megalagrion pacificum,72817,26000,0,98817,6,36773,12173
Megapodius laperouse,865868,1647315,186000,2699183,15,564751,137238
Megaptera novaeangliae,87823,55360292,347870,55795985,15,7921457,4033919
Melamprosops phaeosoma,721771,43662,210556,975989,15,170000,64798
Melanthera kamolensis,11989,0,0,11989,1,11989,11989
Melanthera tenuifolia,26481,507863,2796,537140,4,168654,129655
Melicope adscendens,280807,68877,13220,362904,15,87100,18250
Melicope balloui,99415,22915,1080,123410,15,29742,6513
Melicope christophersenii,21325,8877,2796,32998,3,17726,7669
Melicope degeneri,117783,1577,3388,122748,6,30780,23047.5
Melicope haupuensis,86890,9536,6231,102657,15,23474,5351
Melicope hiiakae,84937,918,2796,88651,3,55943,16496
Melicope knudsenii,264590,68877,8512,341979,15,83800,18140
Melicope lydgatei,141579,888301,10640,1040520,15,174586,65226
Melicope makahae,19399,1042,2796,23237,3,8753,7705
Melicope mucronulata,181494,16932,12734,211160,15,59100,7579
Melicope munroi,64829,6077,3343,74249,14,15731,3450
Melicope ovalis,44755,125926,4095,174776,15,29250,9100
Melicope pallida,56980,55790,20606,133376,15,29783,7761
Melicope paniculata,74944,1577,3283,79804,6,24318,13047
Melicope puberula,85605,1578,2796,89979,6,29713,14266.5
Melicope quadrangularis,61736,1579,3643,66958,15,14540,3500
Melicope reflexa,52613,1580,3343,57536,14,15690,3300
Melicope saint-johnii,31731,26993,5011,63735,12,15677,668.5
Melicope zahlbruckneri,97553,203034,10405,310992,15,67681,17600
Menidia extensa,176850,19992,236350,433192,15,237520,11260
Mentzelia leucophylla,329107,51213,0,380320,11,141496,20400
Mesodon clarki nantahala,18000,6616,650,25266,11,6700,1800
Mezoneuron kavaiense,75507,0,0,75507,1,75507,75507
Microhexura montivaga,171857,67716,6273,245846,15,39800,13500
Microtus californicus scirpensis,948795,390070,2780,1341645,14,451034,38651.5
Microtus mexicanus hualpaiensis,92040,189920,47880,329840,15,58585,14000
Microtus pennsylvanicus dukecampbelli,118617,130090,15000,263707,15,106858,6000
Mimulus michiganensis,115200,17994,4000,137194,6,86464,11754
Mirabilis macfarlanei,1670792,656882,96010,2423684,15,285421,167194
Mitracarpus maxwelliae,51400,100,0,51500,14,10000,3250
Mitracarpus polycladus,51150,100,0,51250,14,10000,3000
Moapa coriacea,3820902,488359,61250,4370511,15,991671,183473
Moho braccatus,78120,0,556,78676,11,27482,6129
Monachus monachus,3256,0,0,3256,1,3256,3256
Monachus schauinslandi,707410,52789852,42400,53539662,15,5827651,3072161
Monachus tropicalis,0,544713,0,544713,6,380000,5800
Monarcha takatsukasae,72625,0,4500,77125,4,25300,20311.5
Monardella viminea,446425,380837,0,827262,4,487334,156302.5
Monolopia (=Lembertia) congdonii,377276,945869,300,1323445,15,293677,65130
Mucuna sloanei persericea,22863,0,2796,25659,3,9591,8187
Mustela nigripes,20667540,17975540,6708527,45351607,15,5462546,1563118
Myadestes lanaiensis rutha,37876,3000,3556,44432,12,8377,2634
Myadestes myadestinus,80770,17221,556,98547,13,27100,4680
Myadestes palmeri,2063817,165489,418199,2647505,15,308758,190729
Mycetophyllia ferox,0,442513,0,442513,1,442513,442513
Mycteria americana,7776477,21579475,451413,29807365,15,6872943,1622372
Myiagra freycineti,14728,0,0,14728,4,8227,2400.5
Myotis grisescens,8120324,15008408,1139954,24268686,15,2851238,1519867
Myotis septentrionalis,2090180,9944245,153979,12188404,1,12188404,12188404
Myotis sodalis,27420719,113873982,4414328,145709029,15,16543137,10256927
Myrcia paganii,60150,265,0,60415,14,10100,2250
Myrsine juddii,90586,889121,5011,984718,15,168118,64726
Myrsine knudsenii,64778,1577,5456,71811,6,16429,12199
Myrsine linearifolia,121258,87790,20174,229222,15,67383,8451
Myrsine mezii,70487,1577,4864,76928,6,17246,13166.5
Myrsine vaccinioides,24556,1042,2796,28394,3,11366,8687
Naemorhedus (=Capricornis) sumatraensis,500,0,0,500,1,500,500
Nasalis larvatus,1000,0,0,1000,1,1000,1000
Navarretia fossalis,3089507,1687584,2000,4779091,15,1831394,127527
Navarretia leucocephala ssp. pauciflora (=N. pauciflora),116066,0,0,116066,8,66000,7730
Navarretia leucocephala ssp. plieantha,103266,23900,1500,128666,10,68550,8278
Neofelis nebulosa,0,61200,0,61200,1,61200,61200
Neoleptoneta microps,356413,27550,19535,403498,15,204700,10085
Neoleptoneta myopica,5000,730,2500,8230,3,5930,1300
Neonympha mitchellii francisci,254975,2141291,16225,2412491,15,405700,148458
Neonympha mitchellii mitchellii,1038273,101481,371500,1511254,15,232477,81558
Neoseps reynoldsi,1997048,2982851,0,4979899,15,1059474,148397
Neostapfia colusana,293466,231185,3000,527651,15,173400,12700
Neotoma floridana smalli,1211365,476972,50300,1738637,15,204931,117165
Neotoma fuscipes riparia,377734,1996958,19000,2393692,15,1094184,84500
Neraudia angulata,96162,1482285,6926,1585373,15,198545,114477
Neraudia ovata,302393,2377543,31552,2711488,15,454010,182636
Neraudia sericea,99160,24465,8652,132277,14,24154,6950
Nerodia clarkii taeniata,119822,16989,0,136811,15,26250,7577
Nerodia erythrogaster neglecta,1328800,865364,74600,2268764,15,837385,80983
Nerodia paucimaculata,648513,73893,11634,734040,12,293052,30356
Nerodia sipedon insularum,393700,60954,250604,705258,11,103500,56854
Nesogenes rotensis,155489,623,100,156212,12,50423,8662.5
Newcombia cumingi,99263,264,0,99527,3,41897,32137
Nicrophorus americanus,4810216,8875201,1165880,14851297,15,2140182,639848
Nitrophila mohavensis,453535,293913,0,747448,13,138267,50905
Nolina brittoniana,106570,142297,26475,275342,15,44582,19400
Nothocestrum breviflorum,341332,921674,27469,1290475,15,339894,53520
Nothocestrum peltatum,148401,42677,8055,199133,14,42200,7124.5
Nototrichium humile,108144,1528301,6054,1642499,15,183142,115208
Notropis albizonatus,355700,32776,720,389196,15,111816,17161
Notropis buccula,64000,4900,0,68900,2,56700,34450
Notropis cahabae,96900,161552,6000,264452,14,173511,3336
Notropis girardi,1001630,1255380,73623,2330633,15,273082,131510
Notropis mekistocholas,699350,170532,236090,1105972,15,262690,61100
Notropis oxyrhynchus,64000,2450,0,66450,2,56600,33225
Notropis simus pecosensis,695560,14933055,38717,15667332,15,2481450,1028500
Notropis topeka (=tristis),6056238,4086144,1351670,11494052,15,2013147,577867.5
Noturus baileyi,362173,169961,38350,570484,15,82746,20575
Noturus crypticus,83400,4328,0,87728,5,45900,8596
Noturus flavipinnis,662338,329531,84936,1076805,15,179612,16700
Noturus placidus,575832,1449985,134700,2160517,15,323913,124549
Noturus stanauli,314200,53092,27633,394925,15,144000,13825
Noturus trautmani,24200,13600,3000,40800,12,13000,1160
Numenius borealis,22600,455558,11254,489412,15,350090,5400
Numenius tenuirostris,794,0,0,794,1,794,794
Oarisma poweshiek,60000,3850,5300,69150,1,69150,69150
Obovaria retusa,474950,479543,18600,973093,14,172600,63546.5
Ochrosia kilaueaensis,39141,4270,6549,49960,15,8848,2674
Odocoileus virginianus clavium,1672503,5964370,0,7636873,15,4018400,102210
Odocoileus virginianus leucurus,5536993,2358625,286862,8182480,15,2324063,279046
Oenothera avita ssp. eurekensis,336842,159435,500,496777,14,104016,29353
Oenothera deltoides ssp. howellii,547646,38700,6500,592846,14,131000,33118
Oncorhynchus (=Salmo) kisutch,13692803,462900490,57803618,534396911,15,24721640,9794895
Oncorhynchus (=Salmo) mykiss,49469260,2266182713,91890731,2407542704,15,67559317,8039667
Oncorhynchus (=Salmo) nerka,539360,356197663,14846632,371583655,15,25098251,11288666
Oncorhynchus (=Salmo) tshawytscha,115921471,2534201208,185124216,2835246895,15,80004247,17631540
Oncorhynchus aguabonita whitei,691511,948219,25315,1665045,15,734500,64207
Oncorhynchus apache,5965133,1370149,2281555,9616837,15,1383420,445500
Oncorhynchus clarki stomias,1130002,2695759,2470307,6296068,15,795393,361132
Oncorhynchus clarkii henshawi,13941944,9289632,317900,23549476,4,9396277,4781061
Oncorhynchus clarkii seleniris,636402,3300,27910,667612,4,434976,92528
Oncorhynchus gilae,6251955,292208,1558535,8102698,15,1817900,185500
Oncorhynchus keta,14400,29497742,5777238,35289380,2,11329733,8925161
Opuntia treleasei,621370,186775,11100,819245,15,255966,29900
Orbicella annularis,0,443246,0,443246,1,443246,443246
Orbicella faveolata,0,446551,0,446551,1,446551,446551
Orbicella franksi,0,408146,0,408146,1,408146,408146
Orcinus orca,41006,18829478,220700,19091184,9,3990517,2314206
Orconectes shoupi,401740,398232,2000,801972,15,365850,29000
Orcuttia californica,588129,376599,5900,970628,15,436980,43668
Orcuttia inaequalis,230366,241313,12050,483729,15,190900,22100
Orcuttia pilosa,274972,294957,1900,571829,15,161100,16190
Orcuttia tenuis,843825,604223,21600,1469648,15,272726,89402
Orcuttia viscida,563577,121684,1700,686961,13,99620,43085
Oregonichthys crameri,3191718,4450672,49820,7692210,15,1151629,458326
Oreomystis bairdi,829776,126234,1000,957010,6,228731,163021
Oreomystis mana,1216862,700399,5656,1922917,15,366600,102588
Orthalicus reses (not incl. nesodryas),174232,26540,0,200772,15,30370,11400
Oryx dammah,0,36950,0,36950,1,36950,36950
Oryx leucoryx,0,1300,0,1300,1,1300,1300
Oryzomys palustris natator,213386,98001,0,311387,15,69752,14083
Osmoxylon mariannense,162948,623,100,163671,12,50423,8747
Ottoschulzia rhodoxylon,154200,28758,0,182958,14,25500,12350
Ovis canadensis nelsoni,1858951,1276000,42205,3177156,8,1017980,276959
Ovis canadensis sierrae,2230135,1510869,850000,4591004,11,1241568,402530
Oxyloma haydeni kanabensis,191739,1128184,302675,1622598,15,213599,87967
Oxypolis canbyi,469027,239616,94177,802820,15,128800,46428
Oxytheca parishii var. goodmaniana,111063,505408,0,616471,15,175230,22400
Oxytropis campestris var. chartacea,65200,10538,27600,103338,15,17400,5378
Pacifastacus fortis,940588,28319,37180,1006087,15,176400,56000
Packera franciscana,18125,47915,5300,71340,4,23025,21956.5
Palaemonetes cummingi,10100,6077,0,16177,6,7000,2450
Palaemonias alabamae,50600,927216,4000,981816,15,243000,36232
Palaemonias ganteri,113900,187180,300,301380,15,45100,17942
Palmeria dolei,601356,64975,85656,751987,15,123316,44800
Pan paniscus,0,575135,0,575135,1,575135,575135
Pan troglodytes,575135,0,0,575135,1,575135,575135
Panicum fauriei var. carteri,41498,56702,7259,105459,15,19313,6779
Panicum niihauense,216031,241055,8432,465518,15,137192,12261
Panthalops hodgsonii,750,0,0,750,1,750,750
Panthera onca,1662978,1980508,447980,4091466,15,803685,196600
Panthera pardus,13000,1800,0,14800,1,14650,7400
Panthera tigris,1122524,15300,0,1137824,1,1137824,1137824
Paronychia chartacea,153970,7851,24159,185980,15,33555,12591
Paroreomyza flammea,48922,5789,3556,58267,12,10109,4590
Paroreomyza maculata,165825,29283,556,195664,14,118140,6649
Partulina semicarinata,47382,0,0,47382,3,28910,12593
Partulina variabilis,47656,0,0,47656,3,29184,12593
Parvisedum leiocarpum,28912,0,100,29012,8,7732,3690
Pavona diffluens,0,350392,0,350392,1,350392,350392
Pedicularis furbishiae,232377,100,60683,293160,15,70602,16850
"Pediocactus (=Echinocactus,=Utahia) sileri",93995,161701,11100,266796,13,34002,20000
Pediocactus bradyi,71634,166213,15950,253797,15,54000,11520
Pediocactus despainii,160532,360659,1200,522391,15,85100,34100
Pediocactus knowltonii,88702,158316,7055,254073,15,31554,18631
Pediocactus peeblesianus fickeiseniae,8000,28500,4000,40500,2,21500,20250
Pediocactus peeblesianus var. peeblesianus,6425,225884,15700,248009,8,104090,16463
Pediocactus winkleri,120600,461535,1000,583135,15,110950,31828
Pegias fabula,1365189,338464,168800,1872453,15,458800,80327
Pelecanus occidentalis,2894642,2612514,232259,5739415,9,837221,597183
Peltophryne lemur,367900,16530,60619,445049,14,137000,26693
Penstemon debilis,147215,39760,7055,194030,5,66730,27844
Penstemon haydenii,648788,746166,12300,1407254,15,218003,70255
Penstemon penlandii,30925,119140,0,150065,15,26700,5308
Pentachaeta bellidiflora,99211,3738,0,102949,8,71970,2157.5
Pentachaeta lyonii,406877,272086,19600,698563,15,146231,33200
Peperomia subpetiolata,54365,918,2796,58079,3,28699,19525
Peperomia wheeleri,105500,5514,0,111014,13,14500,11500
Percina antesella,715200,207807,94500,1017507,15,167500,53200
Percina aurolineata,457800,193326,51000,702126,15,187149,25700
Percina jenkinsi,353500,101465,64947,519912,15,75688,32000
Percina pantherina,1279383,789266,12439,2081088,15,333300,152741
Percina rex,1139473,4542303,258817,5940593,15,1178195,397146
Percina tanasi,444100,161478,25000,630578,15,164684,31000
Perognathus longimembris pacificus,1978480,2271063,67200,4316743,14,803606,289355
Peromyscus gossypinus allapaticola,341006,161316,0,502322,15,85375,25395
Peromyscus polionotus allophrys,1076358,669874,36911,1783143,14,172383,138728
Peromyscus polionotus ammobates,6421005,97741,5000,6523746,15,1318000,252247
Peromyscus polionotus niveiventris,817342,1165120,3775,1986237,15,260598,114570
Peromyscus polionotus peninsularis,1092121,546893,33094,1672108,15,282500,108621
Peromyscus polionotus phasma,492537,108837,3775,605149,14,142336,30765
Peromyscus polionotus trissyllepsis,4768221,743911,148501,5660633,15,3156728,190584
Peucedanum sandwicense,207942,26487,19788,254217,15,95000,7370
Phacelia argillacea,80657,152247,400,233304,14,51000,8250
Phacelia formosula,135716,106971,7055,249742,15,60411,7500
Phacelia insularis ssp. insularis,24946,104365,0,129311,15,18876,7500
Phacelia submutica,168787,181591,7055,357433,5,134366,54744
Phaeognathus hubrichti,893400,192875,193441,1279716,15,624257,31896
Phascolarctos cinereus,0,150,0,150,1,150,150
Phlox hirsuta,792251,3900,9400,805551,15,100027,46671
Phlox nivalis ssp. texensis,345100,2011735,28442,2385277,15,369087,98000
Phoca (=Pusa) hispida hispida,0,135594,0,135594,2,82383,67797
Phoca hispida saimensis,0,6343,0,6343,3,5723,500
Phoca largha,0,1054375,0,1054375,2,791875,527187.5
Phoebastria (=Diomedea) albatrus,7614130,1328118,500,8942748,15,1510214,489801
Phoxinus cumberlandensis,1647441,597390,3220,2248051,15,281028,143000
Phyllostegia bracteata,35906,2942,2796,41644,3,19843,11228
Phyllostegia floribunda,39358,747,0,40105,2,22140,20052.5
Phyllostegia glabra var. lanaiensis,46700,2177,3543,52420,15,12356,1700
Phyllostegia haliakalae,44133,24942,2796,71871,3,27200,22835
Phyllostegia hirsuta,102524,990291,8074,1100889,15,176981,72450
Phyllostegia hispida,531409,1577,4964,537950,7,213271,32429
Phyllostegia kaalaensis,100892,1251523,12551,1364966,15,199145,111284
Phyllostegia knudsenii,54240,1577,4143,59960,15,14028,3400
Phyllostegia mannii,264551,1577,9988,276116,15,145200,9749
Phyllostegia mollis,110414,993398,10583,1114395,15,295855,56242
Phyllostegia parviflora,133353,245945,27368,406666,15,143537,20261
Phyllostegia pilosa,43578,1042,2796,47416,3,17179,16741
Phyllostegia racemosa,495030,138980,20818,654828,15,164605,25254
Phyllostegia renovans,67059,1577,3388,72024,6,16159,13546
Phyllostegia velutina,442014,19955,15899,477868,15,146050,11277
Phyllostegia waimeae,95912,1577,5976,103465,15,21589,4000
Phyllostegia warshaueri,190036,1577,23386,214999,15,44492,9259
Phyllostegia wawrana,61521,2677,3443,67641,14,14030,3750
Physa natricina,1567879,2107896,6973,3682748,15,500448,218482
Physaria douglasii ssp. tuplashensis,38043,3367,800,42210,2,28494,21105
Physaria filiformis,82998,143603,9200,235801,6,61363,40255
Physaria globosa,78500,16540,1337,96377,2,65207,48188.5
Physaria obcordata,136906,183401,7055,327362,15,63094,16301
Physeter catodon (=macrocephalus),43023,20377806,48643,20469472,14,4262227,1647006.5
Picoides borealis,32569085,258196451,9742270,300507806,15,37900480,17915391
Pilosocereus robinii,363512,7831,81400,452743,15,164690,14720
Pinguicula ionantha,616894,424687,16600,1058181,15,437595,30100
Piperia yadonii,617128,694633,41600,1353361,15,266701,85300
Pipilo crissalis eremophilus,413165,1301253,3700,1718118,15,472133,72100
Pittosporum halophilum,49205,1142,2796,53143,3,19370,17021
Pittosporum hawaiiense,30011,5847,0,35858,2,21071,17929
Pittosporum napaliense,70252,1677,2796,74725,6,36667,8333.5
Pityopsis ruthii,244300,205426,0,449726,15,149500,17000
Plagiobothrys hirtus,707217,439830,21429,1168476,15,187336,77312
Plagiobothrys strictus,87854,300,0,88154,9,19342,10000
Plagopterus argentissimus,5895592,2954944,3348314,12198850,15,1284143,464306.5
Plantago hawaiensis,88666,59900,16641,165207,15,25049,10006
Plantago princeps,366582,1488799,36577,1891958,15,212810,136900
Platanthera holochila,276524,4965,9333,290822,15,66300,7900
Platanthera leucophaea,1235681,452697,171530,1859908,14,253670,130770.5
Platanthera praeclara,2113599,1389732,244454,3747785,15,350092,255255
Platydesma cornuta cornuta,49503,419,2796,52718,3,30395,13591
Platydesma cornuta decurrens,22441,419,2796,25656,3,9260,8300
Platydesma remyi,28068,747,0,28815,2,21244,14407.5
Platydesma rostrata,52768,5577,2796,61141,6,13676,11154.5
Pleodendron macranthum,72600,100,0,72700,14,19500,2750
Pleomele fernaldii,27657,1042,2796,31495,3,12271,10328
Pleomele forbesii,20623,1342,2796,24761,3,9767,8174
Pleomele hawaiiensis,263111,815751,33496,1112358,15,145985,62232
Plethobasus cicatricosus,88950,1980211,2011,2071172,15,561270,15222.5
Plethobasus cooperianus,619550,2208416,41866,2869832,15,341200,138177
Plethobasus cyphyus,303110,941813,42830,1287753,4,575095,270848
Plethodon neomexicanus,42000,6900,0,48900,2,25800,24450
Plethodon nettingi,322309,240198,70666,633173,15,87859,45251
Plethodon shenandoah,77389,622086,7100,706575,15,254431,26460
Pleurobema clava,1438850,3010319,427560,4876729,15,475560,164766
Pleurobema collina,1637540,498040,260723,2396303,15,368450,138216
Pleurobema curtum,51700,11069,13200,75969,12,29100,2641
Pleurobema decisum,364059,678470,62727,1105256,15,180623,61558
Pleurobema furvum,69700,205820,0,275520,15,152989,6177
Pleurobema georgianum,234950,128583,34000,397533,15,46500,26218
Pleurobema gibberum,288000,50300,0,338300,15,211281,6600
Pleurobema hanleyianum,46950,15636,3600,66186,6,17700,10775.5
Pleurobema marshalli,19200,13397,13200,45797,13,15300,2220
Pleurobema perovatum,177800,486039,53409,717248,15,156623,44000
Pleurobema plenum,939736,655884,44003,1639623,15,191172,65443
Pleurobema pyriforme,1197853,383981,33000,1614834,15,293600,99892
Pleurobema strodeanum,17269,242332,0,259601,3,123412,97282
Pleurobema taitianum,204550,156977,15709,377236,15,125561,10891
Pleurocera foremani,13900,2951,4000,20851,6,6400,3375
Pleuronaia dolabelloides,39200,16032,0,55232,2,39277,27616
Poa atropurpurea,1223745,579128,0,1802873,14,898137,32913.5
Poa mannii,50676,3187,3343,57206,14,10201,3600
Poa napensis,88539,400,0,88939,9,21292,10000
Poa sandvicensis,92476,3187,3935,99598,14,40910,3150
Poa siphonoglossa,87731,2777,3343,93851,14,41700,3350
Poeciliopsis occidentalis,1255648,9754619,1975980,12986247,15,2956265,667600
Pogogyne abramsii,136847,597634,4900,739381,15,172678,33405
Pogogyne nudiuscula,2316068,2500,0,2318568,13,1777199,1000
Polioptila californica californica,7419629,45280711,344800,53045140,15,34100889,1363671
Polyborus plancus audubonii,1986546,5936611,31500,7954657,15,1276652,437124
Polygala lewtonii,109101,495262,108600,712963,15,123250,30800
Polygala smallii,109000,78269,3100,190369,15,62890,3600
Polygonella basiramia,201301,404234,38859,644394,15,80884,37200
Polygonella myriophylla,225651,128801,18459,372911,14,75700,24000
Polygonum hickmanii,102006,850,0,102856,12,17361,10605
Polygyriscus virginianus,150312,46742,10875,207929,11,49600,18910
Polyphylla barbata,671286,775,0,672061,14,115800,44623.5
Polyscias bisattenuata,16271,0,0,16271,1,16271,16271
Polyscias flynnii,14344,0,0,14344,1,14344,14344
Polyscias gymnocarpa,5317,0,0,5317,1,5317,5317
Polyscias lydgatei,13071,0,0,13071,1,13071,13071
Polyscias racemosa,10375,0,0,10375,1,10375,10375
Polystichum aleuticum,250400,17588,0,267988,13,91000,15500
Polystichum calderonense,71900,100,0,72000,14,23500,4250
Polysticta stelleri,17985635,4807965,40235,22833835,15,2834912,1545430
Pongo pygmaeus,498864,499164,0,998028,1,998028,998028
Porites napopora,0,349861,0,349861,1,349861,349861
Portulaca sclerocarpa,264616,2466114,6359,2737089,15,468510,175955
Potamilus capax,1373786,2059556,196164,3629506,15,412220,210428
Potamilus inflatus,171000,155635,59960,386595,15,67879,21889
Potamogeton clystocarpus,13600,0,13750,27350,12,6750,2000
Potentilla hickmanii,101769,21700,0,123469,15,20570,7500
Potentilla robbinsiana,0,700,0,700,1,700,700
Primula maguirei,41800,75648,400,117848,12,32000,3300
Prionailurus (=Felis) bengalensis bengalensis,10821,9822,0,20643,1,20643,20643
Pristis pectinata,1300,10323589,119840,10444729,13,1555876,722706.5
Pristis pristis,0,209903,0,209903,1,209903,209903
Pritchardia aylmer-robinsonii,24031,10275,9379,43685,9,25310,3300
Pritchardia hardyi,34307,1577,4320,40204,6,10670,6723.5
Pritchardia kaalae,65496,1425502,6182,1497180,15,176656,109187
Pritchardia lanigera,24648,0,0,24648,1,24648,24648
Pritchardia maideniana,13926,19400,0,33326,1,33326,33326
Pritchardia munroi,536506,1577,9517,547600,15,173651,5964
Pritchardia napaliensis,46155,18277,9447,73879,14,21200,3475.5
Pritchardia remota,133231,3984,3343,140558,14,76141,3678
Pritchardia schattaueri,119951,1577,27361,148889,15,19364,9500
Pritchardia viscosa,67200,1577,20554,89331,15,17181,5351
Prunus geniculata,222401,116651,36870,375922,15,39400,26150
Pseudemys alabamensis,456600,264058,71010,791668,14,124759,71219
Pseudemys rubriventris bangsi,135610,32170,66321,234101,12,41408,17296.5
Pseudobahia bahiifolia,267103,263242,200,530545,15,115800,37388
Pseudobahia peirsonii,298137,189272,0,487409,15,143651,20066
Pseudocopaeodes eunus obscurus,905761,735529,27000,1668290,15,211855,119186
Pseudonestor xanthophrys,2411040,257082,306642,2974764,15,1063600,142368
Pseudorca crassidens,0,704890,0,704890,2,607149,352445
Pseudotryonia adamantina,20000,310,0,20310,1,20310,20310
Psittirostra psittacea,79260,27792,556,107608,15,33512,6300
Psychotria grandiflora,75572,1577,5456,82605,6,19571,13726
Psychotria hexandra ssp. oahuensis,36867,424,2796,40087,3,13856,13465
Psychotria hobdyi,46759,1577,6171,54507,6,13527,8578.5
Pteralyxia kauaiensis,92223,55325,16842,164390,15,43500,6856
Pteralyxia macrocarpa,63772,1042,2796,67610,3,49814,9043
Pteris lidgatei,149909,973255,4992,1128156,15,177812,69859
Pterodroma cahow,4700,15000,0,19700,5,15000,2000
Pterodroma phaeopygia,3001894,3138044,13000,6152938,14,818293,420043.5
Pterodroma sandwichensis,384243,1046898,130000,1561141,1,1561141,1561141
Pteropus mariannus mariannus,1968667,4555027,262800,6786494,15,1729744,208212
Pteropus tokudae,77802,478800,0,556602,13,301600,3500
Ptilimnium nodosum,462384,336214,117370,915968,15,98682,53252
Ptychobranchus greenii,160050,82818,30340,273208,12,32300,22340.5
Ptychobranchus jonesi,20969,98926,0,119895,3,56061,45634
Ptychobranchus subtentum,45100,12339,0,57439,2,29370,28719.5
Ptychocheilus lucius,32297893,84777269,4382515,121457677,15,25622891,3319643.5
Puffinus auricularis newelli,5159156,17451701,179100,22789957,15,17372401,406696
Puma (=Felis) concolor coryi,11651221,13400370,26644001,51695592,15,6881300,2649394
Puma (=Felis) concolor costaricensis,0,40480,0,40480,1,40480,40480
Puma (=Felis) concolor couguar,198216,331088,54774,584078,15,189637,30386
Purshia (=Cowania) subintegra,47617,131550,9700,188867,15,23000,14000
Pyrgulopsis (=Marstonia) pachyta,61200,6109,0,67309,12,26000,3993.5
Pyrgulopsis bernardina,96730,1100,17060,114890,4,56180,26400
Pyrgulopsis bruneauensis,1569790,497319,100793,2167902,15,349245,175273
Pyrgulopsis chupaderae,8000,0,0,8000,3,7000,500
Pyrgulopsis idahoensis,421250,158254,0,579504,3,333516,192776
Pyrgulopsis neomexicana,66500,400,9110,76010,15,60000,1300
Pyrgulopsis ogmorhaphe,173400,5577,0,178977,15,39000,5600
Pyrgulopsis roswellensis,77006,24100,7050,108156,11,14000,10100
Pyrgulopsis texana,1000,0,0,1000,1,1000,1000
Pyrgulopsis trivialis,7030,975,74490,82495,4,38720,18250
Pyrgus ruralis lagunae,2045621,196011,0,2241632,14,873350,59006.5
Quadrula cylindrica cylindrica,158948,278358,3250,440556,2,265706,220278
Quadrula cylindrica strigillata,376023,300047,19455,695525,15,222149,41599
Quadrula fragosa,2947388,2493911,104000,5545299,15,895983,187218.5
Quadrula intermedia,832486,1597049,21742,2451277,15,692941,40046
Quadrula sparsa,381115,183172,5600,569887,15,184382,20555
Quadrula stapes,6400,53497,13200,73097,12,26900,3550
Quercus hinckleyi,15305,100,13950,29355,12,7600,500
Rallus longirostris levipes,1071253,5500377,56160,6627790,15,1812036,353378
Rallus longirostris obsoletus,5205255,5128222,103985,10437462,15,1631134,578036
Rallus longirostris yumanensis,1573155,23171932,476880,25221967,15,5260085,848554
Rallus owstoni,3712911,4911513,0,8624424,15,1664928,335200
Rana chiricahuensis,3049604,5352525,2269403,10671532,14,1702694,724024
Rana draytonii,9080385,24976047,0,34056432,7,8087462,4487346
Rana muscosa,2547884,5300576,40310,7888770,14,1023848,366575
Rana pretiosa,1848470,243923,66000,2158393,2,1481712,1079196.5
Rana sevosa,1031270,582730,91009,1705009,5,470425,298832
Rana sierrae,1067266,701702,0,1768968,2,1238230,884484
Rangifer tarandus caribou,3865045,567694,535654,4968393,15,680317,268069
Ranunculus aestivalis (=acriformis),150284,36490,1600,188374,15,40450,4600
Reithrodontomys raviventris,4161390,5574913,545000,10281303,15,2108454,469888
Remya kauaiensis,51180,2677,19782,73639,15,10608,3964
Remya mauiensis,81222,1987,8369,91578,15,11674,6100
Remya montgomeryi,124754,2677,20594,148025,14,45300,5088
Rhadine exilis,297000,1286884,14012,1597896,14,262600,90276
Rhadine infernalis,441500,1567665,19114,2028279,15,417345,109252
Rhadine persephone,124758,31917,13352,170027,14,50000,6183.5
Rhaphiomidas terminatus abdominalis,2362441,5094,200,2367735,14,1673466,51625
Rhinichthys osculus lethoporus,102232,79330,400,181962,11,54733,9580
Rhinichthys osculus nevadensis,2365770,229492,18100,2613362,15,1005996,58462
Rhinichthys osculus oligoporus,303383,23810,6450,333643,12,70030,26345.5
Rhinichthys osculus ssp.,668707,231400,52063,952170,15,178300,54500
Rhinichthys osculus thermalis,72141,129934,0,202075,15,30600,11504
Rhinoceros sondaicus,172040,172040,0,344080,1,344080,344080
Rhinoceros unicornis,219323,219473,0,438796,1,438796,438796
Rhinoptilus bitorquatus,794,0,0,794,1,794,794
Rhodiola integrifolia ssp. leedyi,74366,12220,300,86886,6,38490,10810
Rhododendron chapmanii,493708,135091,11000,639799,15,438500,14800
Rhus michauxii,374268,1917661,122825,2414754,15,332962,163520
Rhynchopsitta pachyrhyncha,13500,0,0,13500,2,10000,6750
Rhynchospora knieskernii,154254,672598,2834,829686,15,184356,40000
Ribes echinellum,245873,104105,14300,364278,15,98463,20100
Rorippa gambellii,478912,161683,3100,643695,15,107261,45456
Rostrhamus sociabilis plumbeus,4083219,8383357,244272,12710848,15,1689190,955039
Sagittaria fasciculata,235200,28713,35449,299362,15,66892,10510
Sagittaria secundifolia,20200,27204,7500,54904,12,14550,3010
Saguinus oedipus,0,150,0,150,1,150,150
Salmo salar,19498718,103426162,4314225,127239105,15,13145296,7607662
Salvelinus confluentus,122006045,333881658,33508865,489396568,15,43809838,32135507
Sanicula mariversa,191773,1398088,3343,1593204,15,170871,115477
Sanicula purpurea,108917,882728,8753,1000398,15,169638,69559
Santalum haleakalae var. lanaiense,15382,0,2131,17513,1,17513,17513
Sarracenia oreophila,405500,387632,13313,806445,15,240905,42986
Sarracenia rubra ssp. alabamensis,37000,0,0,37000,3,16000,11500
Sarracenia rubra ssp. jonesii,852100,38816,25940,916856,15,665629,14177
Scaevola coriacea,65212,50277,18834,134323,13,23195,7400
Scaphirhynchus albus,27449494,487500125,3050671,518000290,15,68778575,41385379
Scaphirhynchus platorynchus,29000,271634,0,300634,5,92547,63000
Scaphirhynchus suttkusi,1522700,331931,159195,2013826,15,497500,55200
Schenkia sebaeoides,8743,0,0,8743,1,8743,8743
Schiedea adamantis,189674,43487,11685,244846,15,97100,7500
Schiedea apokremnos,41273,2397,3343,47013,14,8642,2760
Schiedea attenuata,45883,1577,2796,50256,6,15958,7564.5
Schiedea diffusa ssp. macraei,24204,624,0,24828,2,17481,12414
Schiedea haleakalensis,64852,220291,5619,290762,15,56700,14264
Schiedea hawaiiensis,15063,293947,0,309010,2,156721,154505
Schiedea helleri,43357,1577,7083,52017,14,8773,3900
Schiedea hookeri,74969,344248,3743,422960,15,79856,16791
Schiedea jacobii,34474,1042,2796,38312,3,19525,10243
Schiedea kaalae,154356,879453,16154,1049963,15,199645,19052
Schiedea kauaiensis,125978,42939,20407,189324,15,42819,4864
Schiedea kealiae,49357,530752,5704,585813,15,148171,11229
Schiedea laui,39491,1042,2796,43329,3,18596,14754
Schiedea lychnoides,19145,0,0,19145,1,19145,19145
Schiedea lydgatei,43443,1577,3343,48363,14,10413,2300
Schiedea membranacea,145585,2677,22994,171256,15,44900,5851
Schiedea nuttallii,136461,1444016,28144,1608621,15,198345,116029
Schiedea obovata,31621,365704,2796,400121,4,168654,112120.5
Schiedea salicaria,24461,1042,2796,28299,3,11366,8633
Schiedea sarmentosa,44784,1577,3343,49704,14,10413,2450
Schiedea spergulina var. leiopoda,44470,11415,3343,59228,14,13038,3628
Schiedea spergulina var. spergulina,41814,21491,3343,66648,14,20275,3500
Schiedea stellarioides,53506,2222,5244,60972,14,12240,3050
Schiedea trinervis,28810,465293,2796,496899,4,168654,118512
Schiedea verticillata,59722,1577,3343,64642,14,20426,2528
Schiedea viscosa,8190,0,0,8190,1,8190,8190
Schoenocrambe argillacea,68600,60495,2000,131095,15,33000,7000
Schoenocrambe barnebyi,88800,45279,2000,136079,15,35000,7000
Schoenocrambe suffrutescens,241800,55409,400,297609,15,104050,7300
Schoepfia arenaria,70300,1200,0,71500,14,12800,5500
Schwalbea americana,506634,3060172,134745,3701551,14,742249,239299
Scirpus ancistrochaetus,243997,88141,51922,384060,15,96426,15841
Sciurus niger cinereus,3671988,2972456,243745,6888189,15,1616739,157424
Sclerocactus brevihamatus ssp. tobuschii,200000,6730,0,206730,4,101300,42315
Sclerocactus brevispinus,253600,199775,0,453375,7,159275,60000
Sclerocactus glaucus,357837,1062937,8455,1429229,15,211113,90933
Sclerocactus mesae-verdae,54943,459983,0,514926,9,111800,58808
Sclerocactus wetlandicus,297880,180630,0,478510,7,98025,72230
Sclerocactus wrightiae,191100,848082,400,1039582,14,148600,75600
Scutellaria floridana,116650,383499,7750,507899,15,129062,29500
Scutellaria montana,290400,735663,12348,1038411,14,207071,46982.5
Sebastes paucispinis,0,2466691,665434,3132125,5,891384,608655
Sebastes pinniger,0,2555187,734508,3289695,5,918885,628991
Sebastes ruberrimus,0,2554787,740062,3294849,5,919200,631230
Senecio layneae,278524,946222,0,1224746,15,327300,42200
Serianthes nelsonii,676998,421824,27000,1125822,15,388448,7000
Seriatopora aculeata,0,477704,0,477704,1,477704,477704
Sesbania tomentosa,512443,247234,27241,786918,15,254859,38795
Setophaga kirtlandii (= Dendroica kirtlandii),714700,1337886,703000,2755586,3,1328238,744747
Sibara filifolia,99607,1818711,0,1918318,15,422122,140348
Sicyos albus,11176,923,2131,14230,1,14230,14230
Sidalcea keckii,285735,72138,500,358373,15,63800,19691
Sidalcea nelsoniana,2625029,1054725,22229,3701983,15,772222,164301
Sidalcea oregana ssp. valida,51167,15020,1300,67487,11,15000,5090
Sidalcea oregana var. calva,1345359,198920,12300,1556579,15,730017,41500
Sidalcea pedata,110056,431328,900,542284,11,272735,6685
Silene alexandri,103140,1577,8926,113643,14,20842,6775.5
Silene hawaiiensis,236989,2420429,5575,2662993,15,474510,169224
Silene lanceolata,156724,2499585,8759,2665068,15,454010,172214
Silene perlmanii,76689,1577,13784,92050,15,15650,3600
Silene polypetala,197350,56887,50500,304737,15,54000,14391
Silene spaldingii,3295861,1832720,142287,5270868,14,736359,387857
Sisyrinchium dichotomum,189000,24076,23093,236169,15,24900,17050
Solanum drymophilum,63100,580,0,63680,14,12000,3500
Solanum incompletum,206426,2426876,10002,2643304,15,460010,169937
Solanum sandwicense,203167,13187,30237,246591,15,53410,14400
Solidago albopilosa,172900,67100,4900,244900,14,44000,13350
Solidago houghtonii,242652,83008,2200,327860,14,110966,16971.5
Solidago shortii,1149600,23140,15987,1188727,15,563900,21100
Solidago spithamaea,37700,24375,1166,63241,13,14600,5000
Somateria fischeri,7786141,7157389,15400,14958930,15,2073330,1027630
Somatochlora hineana,2778851,548550,510574,3837975,15,441738,248068
Sorex ornatus relictus,1197589,424384,2500,1624473,14,553033,71020.5
Spelaeorchestia koloana,410901,4000,0,414901,15,82885,16663
Speoplatyrhinus poulsoni,112900,7651,9957,130508,15,35000,3600
Spermolepis hawaiiensis,166318,2781422,12173,2959913,15,456817,197596
Speyeria callippe callippe,706456,1241279,0,1947735,13,1229185,51216
Speyeria zerene behrensii,583347,39790,0,623137,14,100239,36030.5
Speyeria zerene hippolyta,4884561,2682679,76200,7643440,15,1506725,437915
Speyeria zerene myrtleae,126304,125456,0,251760,13,47656,17735
Sphaeralcea gierischii,8350,167000,2000,177350,3,66400,63350
Sphaerodactylus micropithecus,59300,100,0,59400,13,9500,5500
Spheniscus demersus,24000,0,0,24000,1,24000,24000
Sphyrna lewini,0,714891,0,714891,1,336849,208119
Spigelia gentianoides,129600,124247,9120,262967,15,53470,16001
Spiraea virginiana,3106698,591720,38708,3737126,15,1622460,104027
Spiranthes delitescens,21746,796242,14700,832688,15,430450,3635
Spiranthes diluvialis,1609981,7383297,156597,9149875,15,2789999,436487
Spiranthes parksii,391200,438496,33539,863235,15,250680,37020
Stahlia monosperma,244800,400,0,245200,14,93500,10750
Stenogyne angustifolia angustifolia,63986,914741,4320,983047,5,283046,180476
Stenogyne bifida,91278,1577,6463,99318,15,20250,4648
Stenogyne campanulata,67404,2677,5384,75465,15,15515,3500
Stenogyne cranwelliae,14414,747,0,15161,2,9588,7580.5
Stenogyne kanehoana,65869,1006937,8804,1081610,15,292168,49349
Stenogyne kauaulaensis,47166,1042,2796,51004,3,18256,16741
Stenogyne kealiae,73094,1577,4969,79640,6,19571,14309.5
Stephanomeria malheurensis,380451,157980,21429,559860,15,117500,30028
Sterna antillarum,12059553,117613233,1657417,131330203,15,12066118,2785260
Sterna antillarum browni,4940890,27055020,194120,32190030,15,7463329,1788578
Sterna dougallii dougallii,7358450,3860664,564292,11783406,15,5775812,202524.5
Sternotherus depressus,267100,97769,18500,383369,14,89300,16574.5
Streptanthus albidus ssp. albidus,319935,82423,0,402358,12,95182,25408.5
Streptanthus niger,101421,2423,0,103844,10,32116,8114.5
Streptocephalus woottoni,3487465,2339692,11400,5838557,15,1841159,300496
Strix occidentalis caurina,51171283,103561990,7695951,162429224,15,20465308,9511004
Strix occidentalis lucida,3759607,52794878,758354,57312839,15,6579778,3560723
Strymon acis bartrami,213259,28650,0,241909,2,175509,120954.5
Stygobromus (=Stygonectes) pecki,469080,23038,17450,509568,15,149814,21126
Stygobromus hayi,89903,51213,0,141116,11,51478,9408
Stygoparnus comalensis,583008,21978,16782,621768,15,254886,19659
Styrax portoricensis,59400,32534,0,91934,14,32034,3700
Styrax texanus,98700,2900,160038,261638,14,58300,8065
Suaeda californica,457960,13468,400,471828,15,75740,33843
Succinea chittenangoensis,128102,46741,35250,210093,15,67700,10693
Swallenia alexandrae,322811,160419,1000,484230,15,104116,17378
Sylvilagus bachmani riparius,2286705,6874304,118600,9279609,15,1781472,434789
Sylvilagus palustris hefneri,521383,1389551,0,1910934,14,307659,111564
Syncaris pacifica,277831,777193,0,1055024,15,254983,51376
Tamiasciurus hudsonicus grahamensis,751326,869875,433615,2054816,15,285000,114600
Taraxacum californicum,349142,665616,200,1014958,14,272735,53791.5
Tartarocreagris texana,101041,37320,15326,153687,15,50000,5598
Taylorconcha serpenticola,2585271,931688,6973,3523932,15,367026,244545
Tectaria estremerana,47600,100,0,47700,14,8000,2500
Telespyza cantans,127070,27094,0,154164,15,29400,6613
Telespyza ultima,150828,53026,0,203854,12,70677,10000
Ternstroemia luquillensis,51400,100,0,51500,13,11000,2000
Ternstroemia subsessilis,53200,500,0,53700,14,10400,2000
Tetramolopium arenarium,62242,2260284,12819,2335345,15,454010,163163
Tetramolopium capillare,51691,2397,2896,56984,13,15820,2320
Tetramolopium filiforme,70045,1457256,6439,1533740,15,182479,113459
Tetramolopium lepidotum ssp. lepidotum,92863,24848,9724,127435,15,29383,6300
Tetramolopium remyi,84450,6077,7115,97642,15,18250,4564
Tetramolopium rockii,60712,114115,4308,179135,14,42356,4350
Tetrao urogallus cantabricus,794,0,0,794,1,794,794
Texamaurops reddelli,88566,30320,18454,137340,15,30500,5000
Texella cokendolpheri,121574,8420,11226,141220,12,75000,7890
Texella reddelli,64575,70950,14251,149776,15,33350,5200
Texella reyesi,1655600,1586106,21051,3262757,15,1361780,28350
Thaleichthys pacificus,8500,4546466,221251,4776217,5,1112983,1007420
Thalictrum cooleyi,162200,50946,31674,244820,15,46320,12946
Thamnophis eques megalops,131500,468753,143300,743553,2,415440,371776.5
Thamnophis gigas,8719902,26251019,143200,35114121,15,7515428,1715992
Thamnophis rufipunctatus,105500,104000,95850,305350,2,182100,152675
Thamnophis sirtalis tetrataenia,1433392,2497535,9000,3939927,14,958482,194202.5
Thelypodium howellii spectabilis,618484,30310,21429,670223,13,142554,38307
Thelypodium stenopetalum,8911,446359,200,455470,10,272735,4100
Thelypteris inabonensis,63700,100,0,63800,14,13600,2750
Thelypteris pilosa var. alabamensis,19200,5358,0,24558,11,12500,1000
Thelypteris verecunda,60200,100,0,60300,14,10600,2750
Thelypteris yaucoensis,64400,100,0,64500,14,11300,3750
Thermosphaeroma thermophilus,17226,20900,28460,66586,15,9600,4200
Thlaspi californicum,155402,29200,700,185302,11,62600,7500
Thomomys mazama glacialis,100657,939422,19000,1059079,2,777329,529539.5
Thomomys mazama pugetensis,225762,9538,19000,254300,2,141205,127150
Thomomys mazama tumuli,932012,8938,19000,959950,2,880355,479975
Thomomys mazama yelmensis,210204,60938,19000,290142,2,147547,145071
Thymophylla tephroleuca,144400,69534,33144,247078,15,46813,12000
Thysanocarpus conchuliferus,36102,46240,1500,83842,12,18794,7047.5
Tiaroga cobitis,1186417,10990959,1525448,13702824,15,3459513,791160
Todiramphus cinnamominus,359794,1305226,0,1665020,1,1665020,1665020
Torreya taxifolia,181561,347240,83300,612101,15,143200,25668
Townsendia aprica,20500,518962,1200,540662,15,78615,27128
Toxolasma cylindrellus,257100,26904,10546,294550,14,112561,12900
Trematolobelia singularis,181835,1577,5498,188910,15,123080,3200
Trichechus manatus,29204489,49167433,63429310,141801232,15,14707167,9737769
Trichechus senegalensis,2467522,0,0,2467522,1,2467522,2467522
Trichilia triacantha,76700,1116,0,77816,14,11500,4750
Trichostema austromontanum ssp. compactum,319810,0,0,319810,9,236321,8113
Trifolium amoenum,350589,1334422,500,1685511,13,1346100,24000
Trifolium stoloniferum,1001324,1206187,72819,2280330,15,310289,139277
Trifolium trichocalyx,40380,4444,0,44824,10,23200,1505.5
Trillium persistens,58700,35728,54250,148678,15,30250,6400
Trillium reliquum,273600,452947,44900,771447,15,119660,46350
Trimerotropis infantilis,274671,975,0,275646,13,74700,14049
Triodopsis platysayoides,942494,5290,79058,1026842,15,417698,8500
Tryonia alamosae,26000,12200,11410,49610,15,20000,1500
Tryonia cheatumi,20000,2910,0,22910,3,20310,2500
Tryonia circumstriata (=stocktonensis),0,100,0,100,1,100,100
Tuctoria greenei,438786,323795,1700,764281,15,200600,35780
Tuctoria mucronata,330976,55100,0,386076,15,76785,12841
Tulotoma magnifica,165050,277546,8200,450796,15,172589,16200
Tympanuchus cupido attwateri,7542459,829082,485571,8857112,15,1472559,376123
Typhlomolge rathbuni,762534,221669,187269,1171472,15,223010,50850
Uma inornata,2423728,838579,18300,3280607,15,1593186,59000
Uncia (=Panthera) uncia,0,2050,0,2050,1,2050,2050
Urera kaalae,91131,621247,10265,722643,15,292168,25006
Urocitellus brunneus,281520,28180,4207,313907,1,313907,313907
Urocyon littoralis catalinae,736724,202567,0,939291,12,209750,60468
Urocyon littoralis littoralis,612624,2662968,5000,3280592,12,494022,239888
Urocyon littoralis santacruzae,1253922,1274696,7000,2535618,12,507870,151016
Urocyon littoralis santarosae,521602,2464865,0,2986467,12,434313,293654.5
Ursus americanus luteolus,4683736,33073520,1053349,38810605,15,5613874,2027240
Ursus arctos,26517476,54206400,26707199,107431075,15,9699801,1456792.5
Ursus arctos horribilis,26517476,54200453,26707199,107425128,15,9699801,1899104
Ursus arctos pruinosus,0,5947,0,5947,1,5947,5947
Ursus maritimus,14013637,20486243,170877,34670757,8,6804746,3948349
Valvata utahensis,1192503,1663910,9973,2866386,9,497100,333226
Varronia rupicola,13100,100,0,13200,1,13200,13200
Verbena californica,31438,14680,0,46118,13,12300,1800
Verbesina dissita,56119,0,23800,79919,7,32485,3000
Vermivora bachmanii,29708,182215,3423,215346,14,131450,5229
Vernonia proctorii,76600,300,0,76900,14,11200,3500
Vetericaris chaceorum,26091,0,0,26091,2,15291,13045.5
Vicia menziesii,155997,23954,33153,213104,15,25653,14310
Vigna o-wahuensis,280059,2040299,15620,2335978,13,466817,188563
Villosa choctawensis,14569,113617,0,128186,3,79391,30100
Villosa fabalis,98531,354168,29976,482675,4,205607,105622
Villosa perpurpurea,1529107,120590,33175,1682872,15,217166,106527
Villosa trabalis,741879,482344,192692,1416915,15,165695,47573.5
Viola chamissoniana ssp. chamissoniana,71698,1540072,4317,1616087,15,200345,113977
Viola helenae,103031,1777,6855,111663,14,22181,5575.5
Viola kauaiensis var. wahiawaensis,98021,2087,7083,107191,14,23181,6082
Viola lanaiensis,95499,6277,8027,109803,14,20250,6422
Viola oahuensis,244485,930939,5011,1180435,15,168419,69663
Vireo atricapilla,4436915,16290764,512940,21240619,15,4606463,1127323
Vireo bellii pusillus,6117617,38730185,220000,45067802,15,6925553,2872828
Vulpes macrotis mutica,7820165,22020125,123400,29963690,15,4276236,1528053
Vultur gryphus,196188,0,0,196188,1,196188,196188
Warea amplexifolia,89900,7417,84880,182197,15,32600,8600
Warea carteri,92151,11397,20700,124248,15,18000,6700
Wikstroemia villosa,55145,1342,2796,59283,3,29772,19543
Wilkesia hobdyi,49880,115390,20766,186036,15,56288,3600
Xantusia riversiana,340044,1210291,100,1550435,13,513172,37859
Xylosma crenatum,132167,2677,7507,142351,15,42400,5251
Xyrauchen texanus,14319509,126758133,4939337,146016979,15,12859508,9539766
Xyris tennesseensis,678150,56870,40606,775626,15,546825,15886
Yermo xanthocephalus,94062,173494,0,267556,14,40913,20122
Zanthoxylum dipetalum var. tomentosum,182861,11497,20341,214699,15,48980,9820
Zanthoxylum hawaiiense,228935,2477065,15949,2721949,15,459510,173191
Zanthoxylum oahuense,78131,1142,2796,82069,3,55917,15111
Zanthoxylum thomasianum,73500,37459,0,110959,15,25000,4000
Zapus hudsonius luteus,385607,461084,50500,897191,2,610926,448595.5
Zapus hudsonius preblei,3264351,8540178,1051043,12855572,15,2182861,629701
Zizania texana,3040752,48569,144290,3233611,15,674346,247550
Ziziphus celata,589070,51118,253920,894108,15,104500,61500
Zosterops conspicillatus conspicillatus,92644,2500,0,95144,13,44227,1900
Zosterops rotensis,956220,92393,0,1048613,12,272767,46152
